Gs^Fds, Gs^Fds, Gs^Fds, Gs^Fds, Gs^Fms, Hh^Fp, Gs^Fms, Gs^Fds, Gs^Fds, Gs^Fds, Gg^Efm, Gg, Gg, Gg, Gg, Gg, Re, Gg^Efm, Gg, Gg, Gg, Gg, Gg^Efm, Gg^Efm, Gg^Efm, Gg, Gg, Gg, Re, Gg, Gg, Gg
Gll, Gll^Em, Gs^Fms, Gs^Fms, Hh^Fp, Hh^Fp, Gs^Fms, Gs^Fds, Gs^Fds, Gs^Fds, Gll, Gg, Gll, Gg, Re, Re, Gg^Efm, Re, Gll, Gg^_mh, Re, Gg, Re, Gg, Gg^Edb, Gg, Re, Re, Gg^Efm, Gg, Gll, Gg
Gs^Fds, Gs^Fms, Gs^Fms, Hh^Fp, Hh^Fp, Hh^Fp, Gs^Fms, Gs^Fds, Gs^Fds, Gll, Gd^Fetd, Gg, Re, Gg^Es, Gg, Gg^Efm, Gs^Fds, Gll, Gll, Gg, Gg, Re, Gg^Efm, Re, Gll, Gg, Gg^Es, Gg^Efm, Gll, Gg, Gs^Fds, Gg
Gs^Fds, Gs^Fms, Hh^Fp, Hh^Fp, Gs^Fms, Gs^Fms, Gs^Fds, Gs^Fds, Gg, Gll, Re, Re, Gll, Gg, Gs^Fds, Gs^Fds, Gs^Fds, Gs^Fds, Gs^Fds, Gs^Fds, Gs^Fds, Gs^Fds, Gs^Fds, Gll, Gll, Gll, Gll, Gg, Gs^Fds, Gs^Fds, Gs^Em, Gs^Fds
Gs^Fms, Gs^Fms, Hh^Fp, Hh^Fp, Gll^Em, Gll^Em, Gs^Fds, Gg^Efm, Re, Gg^Es, Gs, Gg, Gs^Fds, Gs^Fds, Gs^Fds, Gs^Fds, Gs^Fms, Gs^Fms, Gs^Fms, Gs^Fds, Gll, Gs^Fds, Gs^Fds, Gs^Fds, Gs^Fds, Gs^Fds, Gs^Fds, Gs^Fds, Gs^Fds, Gs^Fds, Gs^Fds, Gs^Fds
Hh^Fp, Gs^Fms, Hh^Fp, Gs^Fms, Gs^Fms, Gs^Fds, Gll, Re, Gll, Gll, Gs^Fds, Gs^Fds, Gs^Fds, Gs^Fds, Gll^Fp, Gs^Fms, Hh^Fp, Gs^Fms, Gs^Fms, Gll^Fp, Gs^Fms, Gll, Gll^Fp, Gs^Fds, Gs^Fds, Gs^Fds, Gll, Gll^Em, Gll^Em, Gs^Fds, Gs^Fds, Gs^Fds
Hh^Fp, Hh^Fp, Hh^Fp, Gs^Fms, Gs^Fms, Gs^Fds, Gll, Re, Gs, Gs^Fds, Gs^Fds, Gs^Fds, Gll^Es, Gs^Fms, Mm, Mm^Esa, Mm, Gs^Fms, Hh^Fp, Gs^Fms, Gs^Fms, Gs^Fms, Hh^Fp, Gs^Fms, Gll^Fp, Gs^Fms, Gs^Fms, Gs^Fms, Gs^Fms, Gs^Fds, Gs^Fds, Gs^Fds
Gs^Fms, Hh^Fp, Hh^Fp, Hh^Fp, Hh^Fp, Gs^Fms, Gg^Es, Gg, Gg^Edb, Gs^Fds, Gs^Fds, Gs^Fds, Gll^Fp, Gll^Es, Gs^Fms, Mm, Gs^Fms, Hh^Fp, Hh^Fp, Gs^Fms, Hh^Fp, Hh^Fp, Hh^Fp, Gs^Fms, Gs^Fms, Gs^Fms, Hh^Fp, Hh^Fp, Hh^Fp, Gll^Fp, Gs^Fds, Gs^Fds
Gs^Fms, Gll^Fp, Hh^Fp, Hh^Fp, Gll^Fp, Gs^Fms, Gll, Re, Gg, Gs^Fds, Gs^Fds, Gs^Fds, Gs^Fds, Gs^Fds, Gll^Fp, Gs^Fms, Hh^Fp, Gs^Fms, Hh^Fp, Hh^Fp, Gs^Fms, Gs^Fms, Hh^Fp, Gs^Fms, Hh^Fp, Hh^Fp, Gs^Fms, Gs^Fms, Gs^Fms, Gll^Fp, Gs^Fds, Gs^Fds
Gs^Fms, Gs^Fms, Hh^Fp, Gs^Fms, Gs^Fms, Gs^Fds, Gg^Efm, Re, Re, Gs^Fds, Gs^Fds, Gs^Fds, Gll^Em, Gs^Fds, Gs^Fds, Gs^Fms, Gs^Fms, Hh^Fp, Hh^Fp, Gs^Fms, Gs^Fms, Gs^Fms, Gs^Fms, Hh^Fp, Hh^Fp, Gs^Fms, Gs^Fms, Gs^Fms, Gs^Fms, Gs^Fms, Gs^Fds, Gs^Fds
Gs^Fms, Hh^Fp, Hh^Fp, Hh^Fp, Gs^Fms, Gs^Fds, Gll, Gg, Gs^Fds, Re, Re, Gs^Fds, Gs^Fds, Gs^Fds, Gs^Fds, Gs^Fms, Gs^Fms, Hh^Fp, Hh^Fp, Gs^Fms, Gs^Fms, Gs^Fms, Gs^Fms, Hh^Fp, Gs^Fms, Hh^Fp, Hh^Fp, Hh^Fp, Gs^Fms, Gs^Fms, Gs^Fds, Gs^Fds
Gs^Fms, Hh^Fp, Hh^Fp, Gs^Fms, Gll, Gll, Gs^Fms, Gs^Fms, Gs^Fms, Gs^Fds, Gll, Gg^Es, Gs^Fds, Gs^Fds, Gs^Fds, Gs^Fds, Gs^Fms, Gs^Fms, Hh^Fp, Gs^Fms, Gs^Fms, Gs^Fms, Gs^Fms, Hh^Fp, Hh^Fp, Gs^Fms, Gs^Fms, Gs^Fms, Gs^Fds, Gs^Fds, Gs^Fds, Gs^Fds
Gs^Fms, Gs^Fms, Hh^Fp, Hh^Fp, Gll, Gs^Fms, Hh^Fp, Gs^Fms, Gs^Fms, Gs^Fds, Gs^Fds, Re, Gg, Gs^Fds, Gs^Fds, Gs^Fds, Gs^Fms, Gs^Fms, Hh^Fp, Gs^Fms, Gs^Fms, Gs^Fds, Gs^Fds, Gll^Fp, Gll^Fp, Gll^Fp, Gs^Fds, Gs^Fds, Gs^Fds, Gs^Fds, Gs^Fds, Gs^Fds
Gs^Fds, Gll^Fp, Gll^Fp, Hh^Fp, Hh^Fp, Hh^Fp, Hh^Fp, Gs^Fms, Gs^Fms, Gs^Fds, Gs^Fds, Re, Gg^Efm, Gll, Gs^Fds, Gs^Fds, Gs^Fds, Gs^Fms, Gs^Fms, Gs^Fms, Gs^Em, Gs^Es, Gs^Fds, Gs^Fds, Gs^Fds, Gs^Fms, Gs^Fds, Gs^Fds, Gs^Fds, Gs^Fds, Gs^Fds, Gs^Fds
Gs^Fds, Gs^Fds, Gll, Gs^Fms, Gs^Fms, Hh^Fp, Gll^Fp, Hh^Fp, Gs^Fms, Gs^Fds, Gs^Fds, Re, Gll, Gll, Gs^Fds, Gs^Fds, Gs^Fds, Gs^Fms, Gs^Fds, Gs^Fms, Gs^Fds, Gs^Fds, Gs^Fds, Gs^Fds, Gs^Fds, Gs^Fds, Gs^Fds, Gs^Fds, Gs^Fds, Gs^Fds, Gs^Fds, Gs^Fds
Gs^Fds, Gs^Fds, Gs^Fds, Gs^Fms, Gs^Fms, Gs^Fms, Gs^Fms, Gs^Fms, Gs^Fms, Gs^Fds, Gs^Fds, Re, Gll, Gs^Fds, Gs^Fds, Gs^Fds, Gs^Fds, Gs^Fds, Gs^Fds, Gs^Fds, Gs^Fds, Gs^Fds, Gs^Fds, Gs^Fds, Gs, Gg, Gg, Gs^Fds, Gs^Fds, Gs^Fds, Gs^Fds, Gs^Fds
Gs^Fds, Gs^Fds, Gs^Fds, Gs^Fds, Gs^Fds, Gs^Fds, Gs^Fds, Gs^Fds, Gs^Fds, Gs^Fds, Gg, Re, Re, Gs^Fds, Gs^Fds, Gs^Fds, Gs^Fds, Gs^Fds, Gs^Fds, Gs^Fds, Gg, Gg, Gg^Qhh, Gg^Qhh, Gg^Qhh, Gs^Qhh, Gg^Qhh, Gg^Em, Gg^Em, Gg^Em, Gg, Gg
Gg, Gg^Em, Gg, Gg, Gg, Gg^Em, Gg, Gg, Gg^Edt, Gg, Cer, Gg^Edt, Re^Vct, Gg, Gg, Gs^Fds, Gg^Em, Gg^Em, Gg, Gg, Gg, Gs^Qhh, Gg^Fds, Gg, Gg^Fds, Gg^Efm, Gg^Efm, Gs^Qhh, Gg^Qhh, Gg^Qhh, Gg^Qhh, Gg^Qhh
Gg, Gg^Efm, Gg^Efm, Gs, Gs^Vc, Gg, Gg, Gg^Ecf, Gg, Cer, Ke, Cer, Gg^Edt, Re, Gg, Gg, Gs^Vc, Gg, Gg^Efm, Gg^Es, Gg, Gg^Qhh, Gg, Gg^Fds, Gg^Fds, Gg^Efm, Gg^Efm, Gg, Ss, Ss, Gg, Gg
Gs^Qhh, Gg^Efm, Gg^Efm, Gg, Hh, Gg, Gg, Gg^Edt, Gg, Cer, Cer, Cer, Re^Vct, Re, Gs, Gs, Gg, Gg, Gg, Gg, Hh, Gg^Qhh, Gs, Gg, Gg, Gg, Gg, Ss, Ss, Ss, Ss, Ss
Gs^Qhh, Gg^Qhh, Gg^Qhh, Gg, Gg, Hh, Hh^Fds, Hh, Gg^Fds, Re^Vct, Gg, Gg^Edt, Gg^Qhh, Re^Qhh, Re^Qhh, Gg, Hh, Hh^Fds, Hh^Fds, Hh^Fds, Hh, Gg^Qhh, Gs, Gs, Sm, Sm, Sm, Ss, Ss, Ss, Ss, Ss
Gs^Qhh, Gs^Qhh, Gg^Fds, Gg^Fds, Gg^Qhh, Hh^Fds, Gg^Fds, Hh^Fds, Gg^Fds, Gg, Gg^Qhh, Gg^Qhh, Gg^Fds, Gg^Fds, Re, Gg^Efm, Gg^Qhh, Hh^Fds, Hh^Fds, Hh^Fds, Gg^Qhh, Gg^Qhh, Gg^Es, Gg, Sm, Sm, Ss^Vhs, Ss, Ss, Ss, Ss, Ss
Gs^Qhh, Gg^Em, Gs^Fds, Gs^Fds, Gg, Gg^Qhh, Gg^Qhh, Gg^Fds, Gg, Gg^Qhh, Gg^Es, Gg, Gg^Efm, Gg^Fds, Gg^Qhh, Gg, Gg^Qhh, Hh, Gg^Qhh, Gg^Qhh, Gg, Gg, Gs^Fds, Gg^Fds, Sm, Sm, Ss, Ss, Ss, Ss, Ww, Ww
Gg^Qhh, Gg, Gs^Fds, Gs^Fds, Gg, Gg^Es, Hh, Gg, Gg, Gs^Vc, Gs, Gg^Efm, Gg^Efm, Gg^Qhh, Re, Gg^Qhh, Gg, Gg^Qhh, Gg^Efm, Gg^Efm, Gg, Gg, Sm, Sm, Sm, Ss, Ss, Ss, Ww, Ww, Wo, Wo
Gg^Qhh, Gg, Gg, Gg^Fds, Hh^Fds, Gg, Hh^Fds, Hh^Fds, Hh^Fds, Gg^Fds, Hh^Fds, Gg^Efm, Gg, Gg^Qhh, Re, Gg, Gg, Gg^Es, Gs^Vc, Gg, Rb, Gg, Rb, Sm, Ss, Ss, Ss, Ww, Ww, Wo, Ww, Wo
Gg^Qhh, Gg, Gg, Hh, Hh^Fds, Hh^Fds, Hh^Fds, Hh^Fds, Hh, Hh^Fds, Hh, Gg, Gg, Gg^Qhh, Gg, Re, Re, Gg, Wwr, Rb, Ww, Ww, Ww, Ww, Ww, Ss, Ww, Ww, Wwr, Ww, Rb, Ww
Gg, Gg^Qhh, Hh^Qhh, Hh^Fds, Hh^Fds, Hh, Gg^Qhh, Hh, Gg^Qhh, Hh, Hh, Hh, Gg^Qhh, Gg^Qhh, Rb, Gg, Wwf, Wwf, Wwf, Ww, Ww, Ww, Ww, Wo, Wo, Ww, Ww, Wo, Ww, Rb, Gg, Gg
Gg, Gg, Hh^Qhh, Hh^Qhh, Gg^Qhh, Gg^Qhh, Gg^Efm, Gg^Qhh, Gg^Efm, Gg^Qhh, Gg^Qhh, Gg^Qhh, Rb, Rb, Rb, Ww, Ww, Wwf, Wwf, Wwf, Gg^Es, Ww, Gs^Fds, Ww, Ww, Ww, Rb, Ww, Rb, Rb, Gg, Gg
Gg, Gg, Gg, Gg^Qhh, Gg, Gg, Gg, Gs^Vc, Gs, Gg, Gg, Gg, Ww, Ww, Ww, Ww, Wwr, Wwf, Gg, Re, Re, Gg, Gg^Em, Gs^Fds, Gs^Fds, Rb, Gg, Gs, Gg, Gg, Gs^Fds, Gs^Fds
Gg, Gg, Gs^Fds, Gg^Fds, Gg^Fds, Gg^Fds, Gg, Gs, Gg, Gg, Ww, Ww, Wo, Wo, Ww, Ww, Ww, Ww, Gg, Gg, Gg, Gg, Re, Gs^Fds, Gg, Gg, Gg^Es, Gg, Gs^Fds, Gs^Fds, Gs^Fds, Gs^Fds
Gg, Gg^Em, Gg^Em, Gg^Fds, Rb, Gg^Fds, Gg, Gg, Gg, Gg, Wwf, Wwr, Ww, Ww, Rb, Rb, Rb, Gg, Gs^Fds, Gs^Fds, Gs^Fds, Gg, Gg, Re, Re, Gg^Efm, Gg^Efm, Gg, Gs^Fds, Gs^Fds, Gs^Fds, Gs^Fds
Gg, Gg^Em, Ww, Rb, Ww, Rb, Ww, Ww, Wwf, Wwf, Wwf, Wwf, Gg, Gg, Gg, Gg, Gg, Gg, Gg, Gs^Fds, Gg, Gg, Gg, Gg, Gg, Gg^Efm, Gg, Gg, Gg, Gg^Em, Gg^Em, Gs^Fds
Ww, Ww, Wo, Ww, Wo, Ww, Ww, Ww, Ww, Wwf, Gg, Gg, Gg, Gg, Gg, Gg, Gg^Es, Gg, Gg, Gg, Gg, Gs^Vc, Gg, Gg, Gg, Re, Gg, Gg, Gg, Gg^Efm, Gg^Efm, Gg
Wo, Wo, Ww, Ww, Ww, Ww, Wwr, Ww, Gg^Efm, Gg^Efm, Gg, Gg^Es, Gs^Vc, Gg, Gg, Gg, Gs, Gg, Gg, Gg^Edb, Gg, Gs, Gg, Gg, Gg, Re, Gg, Gg, Gg, Gg^Efm, Gs^Efm, Gg
Ww, Ww, Gg, Rb, Gg, Gg, Gg, Gg, Gg^Efm, Gg^Efm, Gg, Gs, Gg, Gg, Gg^Efm, Gg, Gg, Gs, Gg, Gg^Efm, Gg^Efm, Gg^Es, Gg, Gg, Gs, Re, Gg, Gs, Gg, Gg, Gg, Gg
Rb, Rb, Gs^Fds, Gs^Fds, Gs^Fds, Gs^Fds, Gs^Fds, Gg^Em, Gs^Fds, Gg, Gs^Fds, Gg, Gg, Gg, Gg^Efm, Gg^Efm, Gg^Efm, Gg, Gg, Gg^Efm, Gg^Efm, Gg, Gg, Gg, Gg, Re, Gg, Gg, Gg^Efm, Gg, Gg, Gg
Gs^Fds, Gs^Fds, Gs^Fms, Gs^Fms, Gs^Fms, Gs^Fds, Gs^Fms, Gs^Fds, Gs^Fms, Gs^Fds, Gs^Fms, Gs^Fds, Gs^Fms, Gg, Gg, Gg^Efm, Gs, Gs, Gg, Gg, Gg, Gg, Gg^Es, Gg^Efm, Gs, Re, Gg, Gg^Efm, Gg, Gg^Efm, Gg, Gg
Gg^Fp, Gs^Fms, Gs^Fms, Gs^Fms, Gs^Fms, Gs^Fms, Gg^Fp, Gs^Fms, Gs^Fms, Gs^Fms, Gg^Fp, Gg^Fp, Gg^Fp, Gs^Fms, Gs, Gs, Gs, Gs, Gs^Es, Gs, Gs, Gs, Hh, Gs, Gs^Qhh, Gs, Gg^Efm, Gg^Efm, Gg, Gg, Gg^Qhh, Gg
Hh^Fp, Gg^Fp, Hh^Fp, Gg^Fp, Hh^Fp, Gg^Fp, Hh^Fp, Gs^Fms, Hh^Fp, Gg^Fp, Hh^Fp, Gg^Fp, Hh^Fp, Gg^Fp, Hh^Fp, Gs, Hh, Gs^Vc, Hh, Hh, Hh, Hh, Mm^Qhh, Hh^Qhh, Gs, Gg^Qhh, Re^Qhh, Gg^Efm, Gs^Qhh, Gs^Qhh, Gg, Gg^Qhh
Mm, Hh^Fp, Hh^Fp, Hh^Fp, Hh, Hh^Fp, Mm^Esa, Hh^Fp, Mm^Esa, Hh^Fp, Mm^Qhh, Hh^Fp, Mm^Qhh, Hh^Fp, Mm^Qhh, Hh, Mm^Qhh, Mm^Esa, Mm^Qhh, Mm^Qhh, Mm^Qhh, Mm^Qhh, Hh, Hh, Gs, Gs, Re, Gg^Qhh, Gs, Gs, Gll^Fp, Gll^Fp
Mm^Qhh, Mm, Mm^Qhh, Mm^Esa, Mm^Qhh, Hh^Fp, Mm^Qhh, Mm^Qhh, Mm^Qhh, Mm^Qhh, Hh^Fp, Mm^Qhh, Hh^Fp, Mm^Qhh, Hh^Fp, Mm^Qhh, Hh^Esa, Mm^Qhh, Hh, Mm^Esa, Hh, Hh, Gs, Gs^Es, Re, Re, Gg, Gg, Gg, Gs, Gll^Fp, Gll^Fp
Mm, Mm^Qhh, Hh^Fp, Mm^Qhh, Hh^Fp, Mm^Qhh, Hh^Fp, Hh^Fp, Hh^Fp, Hh^Fp, Hh^Fp, Hh^Fp, Gs, Hh^Fp, Gd, Gs, Gs, Gs, Gg^Es, Gg, Gs, Gg, Re, Re, Gg, Gg, Gs, Gg, Gg, Gll^Fp, Gll^Fp, Gll^Fp
Hh^Fp, Hh^Fp, Hh^Fp, Hh^Fp, Gs, Hh^Fp, Gs, Gd, Gd, Gd, Gs, Gs^Es, Gs, Gs, Re, Gs, Gg, Re, Re, Re, Gg, Re, Gg, Gg, Gg, Gs, Gs, Gs, Gll^Fp, Gll^Fp, Gll^Fp, Gll^Fp
Gs, Hh^Fp, Gd, Gs, Gd^Es, Gs, Re, Re, Re, Gs^Es, Gs, Re^Es, Re, Re, Gs, Gs^Es, Gll^Fp, Gs, Gll^Fp, Gg, Gd, Gg^_mh, Gs^Es, Gs, Gll^Fp, Gg, Gll^Fp, Gll^Fp, Gll^Fp, Gll^Fp, Gll^Fp, Gll^Fp
Gs, Gs, Gd, Gs, Gs, Gs, Gs, Gs, Gll^Fp, Gs, Gll^Fp, Gs, Gd, Gs, Gll^Fp, Gll^Fp, Gll^Fp, Gll^Fp, Gll^Fp, Gll^Fp, Gll^Fp, Gll^Fp, Gll^Fp, Gll^Fp, Gll^Fp, Gll^Fp, Gll^Fp, Gll^Fp, Gll^Fp, Gll^Fp, Gll^Fp, Gll^Fp
Gs, Gs, Gs, Gs, Gg, Gll^Fp, Gll^Fp, Gll^Fp, Gll^Fp, Gll^Fp, Gll^Fp, Gll^Fp, Gg, Gll^Fp, Gg, Gll^Fp, Gll^Fp, Gll^Fp, Gll^Fp, Gll^Fp, Gll^Fp, Gg, Gg, Gll^Fp, Gll^Fp, Gll^Fp, Gll^Fp, Gll^Fp, Gll^Fp, Gll^Fp, Gll^Fp, Gll^Fp
