Sm, Ss, Sm, Sm, Sm, Sm, Ss^Vhs, Gs, Gs, Gd, Gd, Gd, Gd, Gd, Gd, Gd, Gd, Gd, Gll^Fp, Gll^Fp, Gd, Gd, Gd, Gd, Hh, Gd, Gd, Gd, Hhd^Fp, Gd, Hhd^Fp, Hhd, Hh^Fp, Hhd, Hhd, Gd, Mm, Mm, Mm, Mm, Mm, Mm, Mm, Hhd, Hhd, Mm
Wwg, Sm, Wwg, Ss, Wog, Sm^Edt, Ss, Gs, Gd^Es, Gd, Gs, Gd, Gs^Em, Gd, Gd, Gd, Gd, Gll^Fp, Gll^Fp, Gd^Em, Gd, Gd, Gd, Hh, Hh, Gs^Vl, Gd^Fp, Hhd^Fp, Hhd^Fp, Hhd^Fp, Hh, Hh^Fp, Hh, Hhd, Mm, Mm, Mm, Mm, Hhd, Hh, Mm, Mm, Mm^Esa, Mm^Esa, Hhd, Mm
Wog, Wwg, Sm, Wog, Ss, Wog, Wwg, Gs, Gs, Gd, Gs, Gll^Fp, Gll^Fp, Gll^Fp, Gs, Gd, Gd^Es, Gd, Gd, Gd, Hh, Gd, Gd^Fp, Gd, Gd^Edt, Gd^Es, Hh, Hhd, Hhd, Hhd, Mm, Hh, Mm, Mm, Mm, Mm, Mm, Mm, Hh^Fp, Gd^Es, Gd, Rp, Gs^Es, Hhd, Hhd, Mm
Ss, Sm, Sm^Edt, Sm, Rb, Sm, Ss, Wwg, Rb, Gs, Gs, Gll^Fp, Gll^Fp, Gll^Fp, Gs, Gd, Gs, Gd, Gd, Gd, Hh^Fp, Hh^Fp, Gd^Fp, Gd^Fp, Hhd, Hh, Hh, Hh, Mm, Hhd, Mm, Mm, Mm, Mm, Mm, Mm, Mm^Esa, Mm, Hhd^Fp, Gll^Fp, Gll^Fp, Rp, Gd, Hh, Hhd, Hhd
Ss, Ss^Vhs, Ss, Sm, Rb, Rb, Sm, Wwg, Ss, Rb, Rb, Gs, Gs, Gs, Gs, Gd, Gd^Es, Gs, Hh, Hh, Hh^Fp, Gd^Fp, Gd^Fp, Gd^Fp, Hhd, Hh, Mm, Hhd, Mm, Mm^Esa, Ms^Xm, Ms^Xm, Ms^Xm, Ms^Xm, Ms^Xm, Ms^Xm, Mm, Mm^Esa, Mm, Gll^Fp, Gs^Em, Rp, Gd, Hh, Mm^Esa, Mm
Rb, Rb, Ss, Ss, Ss, Sm, Wog, Wog, Ss, Ss^Vhs, Rb, Gs, Ss, Gs, Rb, Gs, Gd, Gd, Gd, Gs^Vl, Gd, Gd^Fp, Gd^Em, Gd^Em, Mm, Mm, Mm, Mm^Esa, Ms, Ms^Xm, Ms, Ms, Ms, Ms, Ms, Ms^Xm, Ms^Xm, Mm, Mm, Hhd, Gs, Rp^Es, Gd, Hh, Hhd, Mm
Rb, Rb, Wwg, Wwg, Wwg, Wog, Cfr, Rb, Rb, Ss, Ss, Ss, Rb, Ss, Sm, Rb, Gs, Gs, Gs, Gd, Gd, Gd^Fp, Hhd^Fp, Hhd, Hh, Mm, Mm, Ms, Ms^Xm, Ms^Xm, Ha^Fpa, Aa, Aa^Es, Aa, Ha^Fpa, Ha, Ms^Xm, Ms^Xm, Mm, Mm^Esa, Hhd^Esa, Rp, Gd, Hhd, Hhd, Mm
Ss, Ss, Wwg, Wwg, Sm, Ss, Rb, Cfr, Kfr, Cfr, Cfr, Sm, Rb^Edt, Rb, Ss, Rb, Gs, Gs, Gll^Fp, Gd, Gd, Gd, Hhd^Fp, Hh^Fp, Hh, Mm, Mm, Ms^Xm, Ms^Xm, Ms, Aa, Aa, Ha^Qhh, Aa, Aa, Aa, Ha, Ms^Xm, Mm, Hhd, Hhd, Gd, Gd^Es, Hhd, Hh, Mm
Ss, Ss, Wog, Wog, Sm, Sm, Ss, Rb, Cfr, Cfr, Rb, Sm, Ss^Vhs, Ss, Rb, Gs, Gs, Gll^Fp, Gd^Em, Gd, Gd, Gd, Hhd^Fp, Hh^Fp, Mm, Mm, Ms, Ms^Xm, Ms, Ha, Ha, Ai, Aa, Aa, Ha, Aa^Es, Ms^Xm, Ha, Hh^Esa, Hh^Vhh, Hhd, Rp, Gd, Hhd, Hhd, Gd
Wwg, Wog, Ss, Rb, Ss, Ss, Wwg^Bw/, Ss^Bw/, Ss, Sm, Sm, Sm, Rb, Rb, Gs, Gs, Gs, Gll^Fp, Gs^Es, Gd, Gd, Hhd, Hhd^Fp, Hhd, Hhd, Mm^Esa, Mm^Esa, Ms^Xm, Ms, Aa^Fpa, Aa^Es, Aa, Ha, Aa, Ms^Xm, Ms^Xm, Ms, Ms, Mm, Hhd^Esa, Gd, Rp, Gs, Hhd, Mm, Hhd
Wwg, Wog, Ss, Ss, Ss^Edt, Wwg, Wwg^Bw|r, Wwg, Wog, Wog, Wog, Rb, Gs, Gs^Edt, Gs, Gd, Gd, Gd, Gd^Qhh, Gd^Qhh, Gd^Qhh, Gd, Hhd, Hhd, Hh, Mm, Hh^Vhh, Ms, Ms, Ha, Aa, Aa, Ms^Xm, Ms, Ms, Ms, Mm, Mm, Hhd, Hhd, Gd^Es, Gd, Hhd, Hh, Mm, Mm
Wwg, Wwg, Ss, Ss, Wwg, Wwg, Ss^Bw|r, Sm^Edt, Sm, Sm, Wwg, Rb, Gs, Gs, Gs, Gs^Es, Gs, Hh^Qhh, Hh^Qhh, Hh^Qhh, Gd^Qhh, Gd, Gd, Hh, Hhd, Hh, Hhd, Hhd, Hhd^Esa, Hhd, Gd^Esa, Gd^Esa, Ms, Ms, Ms, Mm, Mm, Mm, Hhd, Hhd, Gd, Rp, Hhd, Hh, Mm, Mm
Ss, Wwg, Wwg, Ss, Wwg, Sm, Rb, Rb, Sm, Sm, Wog, Ss, Ss, Ss, Ss, Gs, Gs, Gs, Gs, Gd^Qhh, Gd, Gd, Gd, Gd^Edt, Gd, Gd, Gd, Gd, Gd, Gd^Esa, Gd^Esa, Gd^Esa, Mm, Mm^Esa, Mm, Mm, Hh, Hh, Gd, Gd, Rp^Es, Rp, Hhd, Hhd, Mm, Mm
Sm, Sm, Sm, Wwg, Ss, Sm, Sm, Rb, Ss, Ss, Ss, Wwg, Sm, Rb, Sm^Edt, Ss, Rb, Gll^Fp, Gs^Em, Gd, Gd, Gd^Es, Gd, Gd, Hh, Hhd, Hhd, Hhd, Hh, Hhd, Mm^Esa, Hh, Mm, Mm, Hhd, Hh, Hhd, Hhd, Gd, Rp, Gd, Gd, Mm, Mm^Esa, Mm, Mm
Ss, Sm, Sm, Ss, Sm, Sm^Edt, Sm, Ss^Bw|r, Rb, Rb, Gs^Efm, Wog, Wwg, Sm, Ss^Vhs, Ss, Rb, Gll^Fp, Gll^Fp, Gs, Gd, Gd, Gd, Hhd, Hh, Hhd, Mm, Hh, Hh, Hhd, Mm, Hhd, Hh, Mm, Hhd, Gd, Rp, Rp, Gd, Gs^Es, Gs, Gd, Mm, Mm, Hh, Hh
Rb, Sm, Sm, Ss, Ss^Vhs, Ss, Ss, Gs, Gs^Efm, Gs^Efm, Gs^Efm, Gs, Wwg, Ss, Rb, Sm, Rb, Gs, Gs, Gd^Edt, Gd, Gd, Gd, Hh, Hh^Fp, Mm, Mm, Mm, Mm, Mm, Hh^Fp, Hh, Gs^Es, Hhd, Gs, Gd, Gll^Fp, Gll^Fp, Hhd, Gs, Hhd, Mm, Mm, Mm^Esa, Mm, Hh
Rb, Ss, Ss, Ss, Rb, Ss, Ss, Gs, Gs, Gs^Efm, Gs^Es, Gs, Wog, Gs^Edt, Rb, Rb, Gd, Gs, Hh, Hh^Fp, Hh^Fp, Gd^Em, Gll^Fp, Hh^Fp, Hhd^Fp, Mm, Mm, Mm, Hhd^Fp, Hhd^Fp, Gll^Fp, Gd, Rp, Rp, Gd, Gd, Hh^Fp, Hhd^Fp, Hhd, Hhd, Mm, Mm, Mm^Esa, Hhd, Mm, Mm
Ss, Rb, Ss, Ss, Rb, Rb, Ss, Gs, Gd, Gd^Efm, Gs, Wog, Wwg, Gs, Gs^Efm, Gd^Efm, Gs, Hh, Gs, Hh^Fp, Gll^Fp, Gll^Fp, Gll^Fp, Gll^Fp, Mm, Mm, Mm, Hhd, Gll^Fp, Gll^Fp, Gd, Rp, Gd, Gd, Hh, Hh, Hh^Fp, Hh^Fp, Hhd^Fp, Hhd^Fp, Mm, Mm, Mm, Mm, Hh, Hhd
Ss, Ss, Gs, Sm, Sm, Sm, Gs, Gs, Gs, Gd, Wwg, Wog, Gs, Gs, Gd, Gd, Gd, Gs, Gd, Gd, Gd, Gll^Fp, Hhd^Fp, Gll^Fp, Mm, Mm, Mm, Gd, Gs^Em, Gll^Fp, Rp, Gd, Gd, Hhd, Hhd, Hhd, Mm, Mm^Esa, Mm, Mm, Hhd, Hhd, Hh, Hhd, Hh^Vhh, Hhd
Gs^Qhh, Gs, Gs, Gs, Gs, Gs, Gs, Gs, Gs, Wwg, Gs, Gs, Gll^Fp, Gs, Gs^Vl, Gd, Hh, Gd, Gd, Gd, Gd, Hhd, Hh, Hhd^Fp, Hh, Mm, Mm^Esa, Gs, Gs^Vl, Gd, Rp, Gs, Gs^Es, Hhd, Mm, Mm, Mm, Mm, Mm, Mm, Gs, Hh, Hh, Hh, Hhd, Hh
Gd^Qhh, Gs^Qhh, Gd^Edt, Gs, Gd, Gs, Gs^Es, Gs, Wwg, Wwg, Gs^Efm, Gll^Fp, Gll^Fp, Gll^Fp, Gs, Hh, Hh, Gd, Gll^Fp, Gs, Gs, Hhd, Hh, Hh, Mm, Hhd, Hhd, Gd, Gd, Gd, Rp, Gd, Mm, Mm, Hhd, Wwg, Hhd, Hhd, Gs, Hh, Gs, Gs, Gs, Gs, Gs, Hhd
Gd^Qhh, Gd^Qhh, Gd, Gd, Gs, Gs, Gs, Gs, Wwg, Wwg, Gs^Qhh, Gs^Em, Gs, Gll^Fp, Gs, Gs, Gs, Gs, Gs, Gs^Em, Gs, Hhd, Hhd, Hh, Mm, Mm, Hhd, Hh, Gd, Gd^Es, Rp, Gd, Hh, Hhd, Gs, Wwg, Gs, Gs, Kf, Gs, Gs, Gs^Es, Gs, Gd, Gs^Es, Gs
Gs^Qhh, Gd^Qhh, Gd, Gs, Gs, Gs, Gs^Fp, Gs, Wwg, Wwg, Gs^Qhh, Gs^Qhh, Wwg, Gs, Wog, Wog, Wog, Gs, Wwg, Gs, Gs^Edt, Gs, Hhd, Mm, Mm, Mm, Mm, Hhd, Hhd, Gd, Rp, Gd, Gd, Gs, Wwg, Wwg, Gs, Cf, Cf, Cf, Gs, Gs, Gd, Gd, Gs, Gs
Gs^Qhh, Gd^Es, Gs, Gs, Gs, Gs^Fp, Gs^Fp, Gs^Fp, Gs, Wwg, Wwg, Wwg, Wwg, Wwg, Gs^Qhh, Gs^Qhh, Gs^Qhh, Wwg, Gs^Qhh, Wwg, Gd, Gs, Gs^Vl, Hhd, Hhd, Mm, Mm, Mm, Mm, Mm, Gd, Rp^Es, Wwf, Wwg, Gd, Gd, Gs, Gs, Rd, Gs, Gs^Es, Gd, Gs, Gs^Edt, Gs, Gs
Gs, Gs, Gs, Gs, Gs, Gs^Fp, Hh^Fp, Gs^Fp, Gd^Edt, Kfr^Qhh, Cfr^Qhh, Gs^Qhh, Gs^Qhh, Gs^Qhh, Gs^Efm, Gs^Vh, Gd, Gs^Qhh, Wwg, Wwg, Gd, Gd, Gs, Hh, Hh, Hhd, Mm, Mm, Mm, Hh, Hhd, Gs, Wwg, Rp, Rp, Gs, Rd, Rd, Gs, Gs, Gs, Gs, Gll^Fp, Gs^Em, Gll^Fp, Gs
Gll^Fp, Gs, Gll^Fp, Gs^Vl, Gs, Gs, Hh, Hh^Fp, Gd, Cfr^Qhh, Gs^Qhh, Gd^Efm, Gs^Efm, Gs^Efm, Hh^Fp, Gs^Es, Gs^Qhh, Gs^Qhh, Wwg, Gs, Gll^Fp, Gll^Fp, Gs, Hhd, Hh, Hhd, Mm, Mm, Hhd, Hhd, Wwg, Wwg, Gs, Gs, Rd, Rd, Gs, Gs, Hh, Hh^Fp, Hh^Fp, Gs, Gll^Fp, Gll^Fp, Gll^Fp, Gs
Gll^Fp, Gll^Fp, Gll^Fp, Gll^Fp, Gs, Gs, Gs, Hh, Gs, Gs, Gll^Fp, Gs^Qhh, Gs^Qhh, Hh^Fp, Hh^Fp, Gs^_mh, Gs^Qhh, Wwg, Wwg, Gs, Gs^Em, Gll^Fp, Gs, Gs, Gs, Hhd, Mm, Hh, Hh, Wwg, Wog, Wwg, Gs, Gs^Es, Rd, Gs, Hh, Hh^Vhh, Gs, Hh^Fp, Hh^Fp, Hh^Fp, Gll^Fp, Gll^Fp, Gll^Fp, Gll^Fp
Gll^Fp, Gll^Fp, Gll^Fp, Gll^Fp, Gll^Fp, Gs, Gs^Edt, Gs, Gd, Gs, Gs, Gs, Gs^Qhh, Hh, Gs^Qhh, Gs^Qhh, Gs^Efm, Gs^Efm, Gs^Efm, Wwg, Wwg, Gs, Wwg, Gs^Es, Gs, Mm, Hhd, Hh, Wwg, Wwg, Gs, Wwg, Gs, Gs, Rd, Gs, Hh, Gs, Gs, Gs, Gs, Gll^Fp, Gll^Fp, Gll^Fp, Gll^Fp, Gll^Fp
Gll^Fp, Gll^Fp, Gll^Fp, Gll^Fp, Gll^Fp, Gll^Fp, Gll^Fp, Gs, Gs, Gs, Gd, Gs^Vl, Gd^Es, Gs^Qhh, Gs, Gs, Gs^Fp, Gd^Efm, Gs, Gs, Gs, Wwg, Gs, Wog, Wog, Hhd, Wwg, Wwg, Hh, Gd, Gd, Gd, Gs, Gs, Rd, Gs, Gd, Gs, Gs^Es, Gs, Gs, Gll^Fp, Gll^Fp, Gll^Fp, Gll^Fp, Gll^Fp
Gll^Fp, Gll^Fp, Gll^Fp, Gll^Fp, Gll^Fp, Gll^Fp, Gll^Fp, Gs, Gll^Fp, Gs^Edt, Gs, Gd, Gs, Gs, Gs, Gll^Fp, Gs, Gd, Hh, Hh, Hhd, Gd^Es, Gs, Hh, Hhd, Wog, Hhd, Hh, Gs, Gs, Gs, Gd, Gs^Vl, Gs, Rd, Gs, Gs^Edb, Gd, Gs, Gs, Gs, Gll^Fp, Gs^Em, Gll^Fp, Gs, Gs
Gs^Fms, Gll^Fp, Gs^Fms, Gs^Fms, Gs^Fms, Gll^Fp, Gll^Fp, Gll^Fp, Gll^Fp, Gll^Fp, Gll^Fp, Gs, Gs, Gs, Gd^Edt, Gs, Gs, Hhd^Fp, Hh^Vhh, Hh, Mm, Mm, Hhd, Hhd, Hh, Hh, Gs, Gs, Gs^Es, Gs, Gs, Gs, Gd, Gs, Rd, Gs, Gs, Gd, Gs, Gs, Ce, Gs, Gs, Gs, Gs^Vl, Gs
Gll^Fp, Gll^Fp, Gs^Fms, Gll^Fp, Gs^Fms, Gll^Fp, Gll^Fp, Gll^Fp, Gs^Fms, Gll^Fp, Gs^Fms, Gs^Fms, Gll^Fp, Gs, Gs^Edt, Gd^Es, Hhd^Fp, Hhd^Fp, Mm, Mm, Hhd, Hhd, Hh, Mm, Mm, Gs, Gd, Gs, Gs, Gs, Hh^Fp, Hh^Fp, Gs^Em, Gs, Rd, Gs, Gs, Gs^Es, Gs, Ce, Ke, Ce, Gs, Gs^Efm, Gs, Gs
Gs^Fms, Gs^Fms, Gs^Fms, Gs^Fms, Gll^Fp, Gll, Gll^Fp, Gs^Fms, Gll^Fp, Gs^Fms, Gll^Fp, Gs^Fms, Gll^Fp, Gll^Fp, Gs^Em, Gs, Hh^Fp, Hhd^Fp, Mm, Mm, Hhd, Hh, Hh, Hhd, Gd, Gd, Gs, Gs, Hh, Hh, Hh^Fp, Gll^Fp, Gll^Fp, Gll^Fp, Gll^Fp, Rd, Rd, Gs, Gs, Ce, Ce, Ce, Gs, Gs^Efm, Gs^Es, Gs
Gs^Fms, Gs^Fms, Gs^Fms, Gs^Fms, Gs^Fms, Gs^Fms, Gs^Fms, Gs^Fms, Gll^Fp, Gll^Fp, Gs^Fms, Gll^Fp, Gll^Fp, Gll^Fp, Hhd^Fp, Hh^Fp, Hh^Fp, Hhd^Fp, Mm, Hhd, Mm, Hh, Mm, Mm, Gs, Gd, Gs, Hh, Hh, Hh, Hh, Hh^Fp, Gll^Fp, Gll^Fp, Gll^Fp, Gll^Fp, Gs, Rd, Rd, Gs, Gs, Gs, Gd, Gd, Gs, Gs
Gs^Fms, Gs^Fms, Gs^Fms, Gs^Fms, Gs^Fms, Gs^Fms, Gs^Fms, Gs^Fms, Gs^Fms, Gs^Fms, Gll^Fp, Gll^Fp, Gll^Fp, Gll^Fp, Gs, Hhd^Fp, Gs, Hhd, Gs, Mm, Hh, Hh, Gs, Gs, Gs, Gs, Gs, Gs, Gs, Gs, Gs, Gs, Gs, Gll^Fp, Gll^Fp, Gll^Fp, Gs, Gs, Rd, Gs, Gs, Gd, Gs, Gd, Gs, Gs
