Gs, Gd, Gs, Gd, Gd, Gd, Hh, Gd, Gd, Gd, Gd, Gs, Gd, Gd, Gd, Gd, Gs, Gs, Gs, Gs, Gs, Gd, Gd, Gd, Gd, Gd, Gd^Fp, Gd^Fp, Gll^Fp, Gll^Fp, Gll^Fp, Gd^Fp, Gll^Fp
Gd, Gs, Gs^Edb, Gd, Gd^Es, Hhd, Md, Hh, Ms^Xm, Gd, Mm, Gd, Gd, Gd^Vd, Ko, Gd^Es, Gd^Es, Gs, Gd, Gs^Edb, Gd, Gd, Gd, Gd, Gd, Gd^Fp, Gd^Fp, Gd^Fp, Gll^Fp, Gll^Fp, Gll^Fp, Gll^Fp, Gll^Fp
Gd, Gd, Gd, Gd, Gd^Vd, Hh, Hhd, Mm, Mm, Mm, Md, Hhd, Hh, Co, Co^Ecf, Co, Gd, Re^Es, Re, Gd, Gd, Gd, Re, Gd, Gs, Gs^Fp, Gs^Fp, Gd^Fp, Gs^Fp, Gll^Fp, Gll^Fp, Gll^Fp, Gd^Fp
Hhd, Hhd^Es, Hh, Gd, Hhd^Es, Hhd, Hh, Mm, Mm, Mm, Hh^Es, Hhd, Co, Co, Hh, Hhd, Hh^Esa, Gd, Gd, Re, Gd, Re, Gd, Re, Re, Gs, Gs, Gs^Fp, Gs^Fp, Gd^Fp, Gd^Fp, Gll^Fp, Gd^Fp
Hh, Hhd, Ms^Xm, Hh, Hh^Esa, Hhd, Md, Md, Md, Mm, Mm, Hh, Hh, Co, Hh, Hh, Ms^Xm, Gd, Gd, Gd, Gs, Gd, Gd, Gd, Gd, Gd^Edt, Re, Gs^Em, Gs^Fp, Gd^Fp, Gd^Fp, Gll^Fp, Gd^Fp
Ms^Xm, Mm, Mm^Esa, Ms^Xm, Mm^Esa, Md, Md, Md, Mm, Mv, Mm^Es, Mm^Esa, Mm, Hhd, Mm, Mm, Mm, Md^Esa, Gd, Gd, Gd, Gd, Hhd, Hh, Gd, Gd, Re, Gd, Gs, Gd^Fp, Gll^Fp, Gd^Fp, Gd^Fp
Mm, Mm, Mm, Mm, Mm, Md, Mm, Md, Mm, Mm, Mm, Ms^Xm, Mm^Esa, Mm, Md, Mm, Mm, Mm, Mm, Gd, Hhd, Hhd, Ds^Es, Ds, Ds, Gd, Gd, Gd, Gd, Gd^Em, Gll^Fp, Gll^Fp, Gll^Fp
Ms^Xm, Mm, Md, Mm, Mm, Mm, Hhd^Vd, Hh^Es, Ms^Xm, Mm, Mm^Esa, Mm^Esa, Ha, Hhd^Esa, Hh^Vd, Mm, Mm, Mm, Hh, Hhd, Rd, Re, Wwg, Wwg, Wwg, Wwg, Ds, Gd^Edb, Gd, Gd, Hhd^Fp, Gll^Fp, Hh^Fp
Gd, Md, Gd, Gd, Gd, Hh, Hhd^Es, Hhd, Mm, Ms^Xm, Mm^Esa, Ms^Xm, Ha, Ha, Ha, Ha, Ai^Esa, Hh, Hh, Rd^Vd, Wog, Wog, Wwg, Wwg, Rd, Ds^Es, Gll^Fp, Re, Hh, Hhd, Hh, Hh^Fp, Hhd^Fp
Gd, Gd, Gd, Gd, Gd, Gd, Gd, Hh, Mm, Mm, Mm, Md, Mm, Ha, Ai^Esa, Ai^Esa, Ai, Ai, Wog, Re, Wog, Wwg, Wwg, Re, Gll^Fp, Gll^Fp, Gll^Fp, Re, Re, Hhd, Gs, Hhd^Fp, Hhd
Gll^Fp, Gll^Fp, Gll^Fp, Gd^Es, Gd, Gd^Edb, Gd, Gd, Gd, Mm, Mm, Mm, Re, Ai^Esa, Ai, Ai^Esa, Ai^Esa, Wog, Wog, Wog, Wog, Wwg^Es, Wwg, Rd, Ds^Es, Ds, Rd, Wwg, Re, Gd, Gs, Hh, Gd
Gll^Fp, Gll^Fp, Gll^Fp, Gll^Fp, Gd^Em, Gd, Gd, Gd, Ds^Es, Rd, Rd, Rd, Re, Rd, Wwg, Ai, Wog, Wog, Wog, Wog, Wog, Wog, Wog, Wwg, Wwg, Ds^Es, Wwg, Wwg, Gd, Re, Gs, Gs, Gd
Gll^Fp, Gll^Fp, Gll^Fp, Gll^Fp, Gd, Gd, Ds, Ds^Es, Wwg^Es, Wwg, Wog, Wog, Wog, Wwg, Wwg, Wwg, Wog, Wog, Wog, Wog, Wog, Wwg, Wwg, Wwg, Ds^Es, Wwg, Rd, Gd, Gd, Re, Re, Gs^Edt, Gs
Gd^Fp, Gll^Fp, Gll^Fp, Gd^Fp, Gd^Es, Gs, Rd, Wwg, Re, Wwg, Ds, Rd, Ds^Es, Wwg, Wog, Wwg, Wog, Wog, Re^Vd, Wog, Wwg, Wwg, Wwg, Ds, Hh, Ds, Gd, Gd, Gd^Vd, Gs, Re, Re, Gd
Gd^Fp, Gd^Fp, Gs^Fp, Gd^Fp, Gd^Fp, Gd, Gd, Rd, Hh, Rd, Hhd^Vd, Ds, Ds, Wwg, Wwg, Wwg, Wog, Wog, Rd^Es, Rd, Wog, Wwg, Wwg, Rd, Rd, Gd, Co^Ecf, Hh, Hhd, Gd, Gd, Gd, Gll^Fp
Gd^Fp, Gll^Fmf, Gs^Fp, Gd^Fp, Gd^Fp, Gll^Fmf, Gd^Fp, Gd^Fp, Gd^Fp, Hh^Fp, Re, Rd, Wwg, Wwg, Wwg, Wwg, Wwg, Wwg, Wwg, Wwg, Wwg, Wwg, Wog, Wwg, Wog, Rd, Gd, Hhd, Gd, Gd, Gd, Gll^Fp, Gll^Fp
Gd^Fp, Gd^Fp, Gll^Fmf, Gd^Fp, Gll^Fmf, Gd^Fp, Gd^Fp, Gd^Fp, Gd, Rd, Wwg, Wwg, Wwg, Wwg, Rd, Wog, Wwg, Wwg^Es, Wwg, Wwg, Rd, Re, Ds^Es, Wwg, Wwg, Wwg, Ds, Gd, Re, Gd, Gd, Gll^Fp, Gll^Fmf
Gd^Fp, Gd^Fp, Gd^Fp, Gs^Fp, Gd, Gd^Fp, Gd, Gd^Em, Co^Ecf, Gd, Ds, Wog, Ds, Ds^Es, Re, Wog, Wog, Wwg^Bw|, Ds^Es, Rd, Gll^Fp, Gd, Gd, Ds^Es, Re, Wwg, Ds^Es, Gd, Re, Gd, Gll^Fmf, Gll^Fp, Gll^Fmf
Gd, Gd^Em, Gd, Gd, Gd, Gd, Gd^Es, Gs, Gs, Gd, Gd, Ds, Gd^Vd, Rd, Re, Wwg, Wwg, Ds, Gd, Gd, Gll^Fp, Gll^Fmf, Gd, Gd, Gd, Ds, Gs^Edb, Gd, Gd, Gd^Em, Gll^Fmf, Gll^Fp, Gll^Fmf
Gd, Gd, Hhd, Hhd, Gd, Gd, Gd, Gd, Gs, Gd, Gd, Hhd, Hhd, Hh, Rd, Wwg, Wwg, Ds, Gd, Gd, Gd^Em, Gll^Fmf, Gll^Fmf, Gd, Gd, Gd, Re, Re, Gd, Gll^Fmf, Gll^Fp, Gll^Fmf, Gll^Fmf
Hh, Hh, Gd, Gd, Gs, Gd, Gd, Gd, Gd, Gs, Gd, Hhd, Gd, Gd, Gd, Rd, Gd, Gd, Gd, Hh, Hhd^Fmf, Hhd^Fmf, Hh^Fmf, Gd, Gd, Re, Gd, Gd, Gll^Fmf, Gll^Fmf, Gll^Fp, Gll^Fp, Gll^Fmf
Gd, Hh, Gd, Gs^Vd, Gs, Gd, Gll^Fp, Gll^Fp, Gll^Fp, Gd^Es, Gd, Gd, Gd, Gd, Gd, Gs^Edt, Gd, Gd, Gd, Hhd^Vd, Gd, Hhd^Fmf, Re, Re, Gd, Gd, Gd, Gll, Gll^Fmf, Gll^Fmf, Gll^Fmf, Gll^Fmf, Gll^Fmf
Gd, Gd^Es, Gd, Gs^Edb, Gd, Gll^Fp, Gll^Fp, Gll^Fmf, Gll^Fp, Gll^Fp, Gll^Fp, Gll^Fp, Gll^Fp, Gd^Em, Gll^Fp, Gd, Gll^Fdf, Gll^Fdf, Gll^Fdf, Gd, Gll, Gd, Re, Re, Gd, Gd, Gll, Gll^Fdf, Gll^Fdf, Gll^Fmf, Gll^Fdf, Gll^Fdf, Gll^Fdf
Gd, Gd, Hh, Gd, Gll^Em, Gll^Fp, Gll^Fp, Gd^Fmf, Gll^Fmf, Gll^Fp, Gll^Fmf, Gll^Fp, Gll^Fmf, Gll^Fp, Gll^Fmf, Gll^Fp, Gll^Fp, Gll^Fdf, Gll^Fdf, Gll^Fdf, Re, Gs, Gs^Es, Gs, Gs, Gd, Gd, Gll, Gll^Em, Gll^Fdf, Hh, Gll^Fdf, Mm
Hh, Hh, Gd, Gd, Gd^Fmf, Gd^Fmf, Gd^Fmf, Gll^Fp, Gll^Fmf, Gll^Fmf, Gll^Fmf, Gll^Fmf, Gs^Fmf, Gll^Fmf, Gs^Fmf, Gd^Fmf, Gll^Fdf, Gll^Fdf, Gll^Fdf, Gll, Re, Gs, Hh^Vhh, Gs, Gs, Gs, Gs^Es, Gs, Hh, Hh, Mm, Mm, Mm
Gd, Hhd, Gd, Gll, Gd^Fmf, Gd^Fmf, Gll^Fmf, Gd^Fmf, Gll^Fp, Gll^Fp, Gs^Fmf, Gs^Fmf, Gs^Fmf, Gs^Fmf, Gll^Fmf, Gll^Fdf, Gll^Fdf, Gll^Fdf, Gll, Gll, Re, Hh, Hh, Hh, Gs, Gs, Hh, Hh, Mm, Mm, Mm^Xm, Mm^Xm, Mm
Gd, Gd, Gd^Fmf, Gd^Fmf, Gd^Fmf, Gd^Fmf, Gd^Fmf, Gs^Fmf, Gs, Gll^Fmf, Gll^Fmf, Gll^Fmf, Gll^Fmf, Gll^Fmf, Gll^Fmf, Gll^Fdf, Gll^Fdf, Gll^Fdf, Gll, Gll, Re, Hh, Hh, Hh, Gs, Gs, Gs, Hh, Mm, Mm, Mm, Mm, Mm
