Xu, Xu, Xu, Xu, Xu, Xu, Uu, Xu, Xu, Wog, Wog, Wwg, Wwrg, Xu, Xu, Xu, Qxua, Qxua, Qxua, Qxua, Qxua, Qxua, Qxua, Qxua, Qxua, Qxua, Qxua, Qxua, Qxua, Qxua, Qxua, Qxua
Xu, Xu, Xu, Xu, Xu, Xu, Rr^Pw|, Xu, Xu, Wog, Wog, Wwrg, Xue, Xu, Xue, Xu, Qxua, Qxua, Qxua, Qxua, Qxua, Qxua, Qxua, Qxua, Qxua, Qxua, Qxua, Qxua, Qxua, Qxua, Qxua, Qxua
Xu, Xu, Xu, Xu, Uu^Tf, Uu^Tf, Uh^Em, Uh, Wwg^Es, Wog, Wwg, Wwg, Uhe, Xue, Xue, Xu, Qxua, Qxua, Qxua, Qxua, Qxua, Qxua, Qxua, Qxua, Qxua, Qxua, Qxua, Qxua, Qxua, Qxua, Qxua, Qxua
Xu, Xu, Xue, Uh^Tf, Uh^Tf, Ur^Em, Ur^Es, Wwg, Wog, Wog, Wwg^Es, Uue^Tf, Uhe^Tf, Uh, Xue, Xu, Qxua, Qxua, Qxua, Qxua, Qxua, Qxua, Qxua, Qxua, Qxua, Qxua, Qxua, Qxua, Qxua, Qxua, Qxua, Qxua
Xu, Xu, Xue, Uh, Ur^Edb, Ur^Em, Wwf, Wwg, Wwf, Wwg^Es, Uu^Es, Uue^Tf, Uue^Edb, Uhe, Tb, Xu, Qxua, Qxua, Qxua, Qxua, Qxua, Qxua, Qxua, Qxua, Qxua, Qxua, Qxua, Qxua, Qxua, Qxua, Qxua, Qxua
Xu, Xue, Ur, Uhe^Qhh, Uue, Kte, Wog, Wwg, Wwf, Wwf, Tb, Xu, Uue^Qhh, Uue^Qhh, Ur^Edb, Xu, Xu, Qxua, Qxua, Qxua, Qxua, Qxua, Qxua, Qxua, Qxua, Qxua, Qxua, Qxua, Qxua, Qxua, Qxua, Qxua
Xu, Xu, Ur, Tb, Wwg^Es, Wwg^Es, Wog, Wog, Uh^Tf, Ur, Ur, Ur, Ur, Ur, Tb, Xu, Xu, Qxua, Qxua, Qxua, Qxua, Qxua, Qxua, Qxua, Qxua, Qxua, Qxua, Qxua, Qxua, Qxua, Qxua, Qxua
Xu, Xu, Ur^Em, Uue, Wwg^Es, Wog, Wwrg, Wog, Uh^Tf, Uu^Tf, Uu^Tf, Ur, Xu, Uu^Edt, Xu, Xu, Xu, Qxua, Qxua, Qxua, Qxua, Qxua, Qxua, Qxua, Qxua, Qxua, Qxua, Qxua, Qxua, Qxua, Qxua, Qxua
Xu, Xu, Xu, Uh, Wwf, Wog, Wwg, Uh, Tb, Ur^Tf, Uu^Es, Uu^Em, Uh, Ur, Xu, Xu, Qxua, Qxua, Qxua, Qxua, Qxua, Qxua, Qxua, Qxua, Qxua, Qxua, Qxua, Qxua, Qxua, Qxua, Qxua, Qxua
Xu, Xu, Xu, Wwf, Wwf, Wwf, Uu^Qhh, Tb, Kte, Uu, Ur, Ur^Edt, Uh^Qhh, Uh^Qhh, Xu, Xu, Qxua, Qxua, Qxua, Qxua, Qxua, Qxua, Qxua, Qxua, Qxua, Qxua, Qxua, Qxua, Qxua, Qxua, Qxua, Qxua
Xu, Xu, Xu, Wog, Wog, Wwrg, Xu, Uue, Uue^Em, Ur^Edb, Ur, Uh, Xue, Xue, Xu, Xu, Xu, Qxua, Qxua, Qxua, Qxua, Qxua, Qxua, Qxua, Qxua, Qxua, Qxua, Qxua, Qxua, Qxua, Qxua, Qxua
Xu, Xu, Xu, Wog, Wog, Wwg^Es, Ur^Em, Ur^Edt, Uue^Tf, Ur^Tf, Uu, Xue, Xu, Xu, Xu, Xu, Xu, Qxua, Qxua, Qxua, Qxua, Qxua, Qxua, Qxua, Qxua, Qxua, Qxua, Qxua, Qxua, Qxua, Qxua, Qxua
Xu, Xu, Xu, Wog, Wog, Wwf, Ur^Edb, Uue^Tf, Uhe^Tf, Uhe^Tf, Uu^Em, Xue, Xu, Xu, Xu, Xu, Qxua, Qxua, Qxua, Qxua, Qxua, Qxua, Qxua, Qxua, Qxua, Qxua, Qxua, Qxua, Qxua, Qxua, Qxua, Qxua
Xu, Xu, Xu, Wwf, Wwf, Wwf, Ur^Edt, Tb, Uh, Uhe, Uh^Qhh, Xu, Xu, Xu, Xu, Qxua, Qxua, Qxua, Qxua, Qxua, Qxua, Qxua, Qxua, Qxua, Qxua, Qxua, Qxua, Qxua, Qxua, Qxua, Qxua, Qxua
Xu, Xu, Xu, Wwf, Xu, Wwg, Wwg, Ur, Ur^Es, Uh^Qhh, Tb, Xu, Xu, Xu, Xu, Qxua, Qxua, Qxua, Qxua, Qxua, Qxua, Qxua, Qxua, Qxua, Qxua, Qxua, Qxua, Qxua, Qxua, Qxua, Qxua, Qxua
Xu, Xu, Xu, Wwf, Wwg^Es, Wwg, Wog, Uue, Kte, Ur^Em, Xu, Xu, Xu, Xu, Xu, Qxua, Qxua, Qxua, Qxua, Qxua, Qxua, Qxua, Qxua, Qxua, Qxua, Qxua, Qxua, Qxua, Qxua, Qxua, Qxua, Qxua
Xu, Xu, Xu, Wwf, Tb, Wog, Wog, Uue, Uhe, Ur^Em, Xu, Xu, Xu, Xu, Xu, Qxua, Qxua, Qxua, Qxua, Qxua, Qxua, Qxua, Qxua, Qxua, Qxua, Qxua, Qxua, Qxua, Qxua, Qxua, Qxua, Qxua
Xu, Xu, Xu, Xue, Uhe, Uue, Wwf, Wog^Es, Wwf, Uh^Qhh, Uh^Qhh, Xu, Xu, Xu, Qxua, Qxua, Qxua, Qxua, Qxua, Qxua, Qxua, Qxua, Qxua, Qxua, Qxua, Qxua, Qxua, Qxua, Qxua, Qxua, Qxua, Qxua
Xu, Xu, Xu, Xue, Xue, Ur^Em, Ur, Wwg, Wwg, Ur^Edt, Ur^Edt, Xu, Xu, Xu, Xu, Qxua, Qxua, Qxua, Qxua, Qxua, Qxua, Qxua, Qxua, Qxua, Qxua, Qxua, Qxua, Qxua, Qxua, Qxua, Qxua, Qxua
Xu, Xu, Xu, Xu, Xue, Uue, Uue, Wwg, Wog, Xu, Ur^Tf, Uu^Edb, Xu, Xu, Xu, Qxua, Qxua, Qxua, Qxua, Qxua, Qxua, Qxua, Qxua, Qxua, Qxua, Qxua, Qxua, Qxua, Qxua, Qxua, Qxua, Qxua
Xu, Xu, Xu, Xu, Xu, Ur, Uh^Qhh, Wwg^Es, Wog, Wwrg, Uue^Tf, Ur, Xu, Xu, Xu, Qxua, Qxua, Qxua, Qxua, Qxua, Qxua, Qxua, Qxua, Qxua, Qxua, Qxua, Qxua, Qxua, Qxua, Qxua, Qxua, Qxua
Xu, Xu, Xu, Xu, Xue, Kte, Ur^Es, Wwf, Wog, Wwg^Es, Ur^Em, Ur^Em, Xu, Xu, Xu, Qxua, Qxua, Qxua, Qxua, Qxua, Qxua, Qxua, Qxua, Qxua, Qxua, Qxua, Qxua, Qxua, Qxua, Qxua, Qxua, Qxua
Xu, Xu, Xu, Xue, Tb, Ur^Em, Ur^Tf, Wwf, Wwg, Wwf, Uue^Qhh, Tb, Xue, Xu, Xu, Qxua, Qxua, Qxua, Qxua, Qxua, Qxua, Qxua, Qxua, Qxua, Qxua, Qxua, Qxua, Qxua, Qxua, Qxua, Qxua, Qxua
Xu, Xu, Uh^Qhh, Ur, Uue^Tf, Uue^Tf, Wwg, Wwg, Wog, Wwf, Tb, Xue, Xu, Xu, Qxua, Qxua, Qxua, Qxua, Qxua, Qxua, Qxua, Qxua, Qxua, Qxua, Qxua, Qxua, Qxua, Qxua, Qxua, Qxua, Qxua, Qxua
Xu, Xu, Uh^Qhh, Uu, Uhe^Tf, Uhe^Tf, Wog, Wog, Wwg^Es, Wwg, Xu, Xu, Xu, Xu, Qxua, Qxua, Qxua, Qxua, Qxua, Qxua, Qxua, Qxua, Qxua, Qxua, Qxua, Qxua, Qxua, Qxua, Qxua, Qxua, Xu, Xu
Xu, Xu, Ur^Es, Ur^Edb, Uue^Tf, Wwf, Wog, Wwrg, Uhe^Qhh, Xu, Xu, Xu, Xu, Xu, Qxua, Qxua, Qxua, Qxua, Uh^Qhh, Qxua, Uu^Qhu, Qxua, Qxua, Qxua, Uh, Uh, Uu^Qhu, Qxua, Qxua, Qxua, Xu, Xu
Xu, Xu, Xu, Ur^Em, Wwf, Wwf, Wwf, Wwg, Kte, Ur^Em, Xu, Xu, Xu, Xoa, Qxua, Qxua, Uu^Qhu, Uh^Qhh, Uh^Qhh, Uu^Qhu, Uu^Es, Uh, Uu^Qhu, Uu^Qhu, Uu^Es, Uu, Uu, Uu^Qhu, Uu^Qhu, Xoa, Xoa, Xu
Xu, Xu, Uh^Qhh, Ur^Es, Wwf, Wwf, Wwf, Uue^Tf, Ur, Uu^Tf, Uh^Tf, Uh^Qhh, Uu^Edt, Xu, Xoa, Uu^Qhh, Urb^Eb, Uu, Xoa, Uu, Urb^Eb, Uu, Xoa, Uu, Urb^Eb, Exos^Cov, Exos^Cov, Exos^Cov, Uu, Uu^Es, Xoa, Xu
Xue, Xue, Uue^Tf, Uue^Qhh, Wog, Wog, Wwg^Es, Ur^Es, Ur^Es, Uu^Tf, Ur, Uh^Qhh, Ur, Uu^Edt, Urb, Urb, Urb, Urb, Urb, Urb, Urb, Urb, Urb, Urb, Urb, Urb, Urb, Exos^Cov, Exos^Kov, Uh^Qhh, Xoa, Xu
Xue, Xue, Uhe, Wwrg, Wog, Wwg, Wwf, Uue^Es, Xue, Uh, Tb, Ur, Uu, Uu^Edb, Xoa, Urb, Urb^Eb, Urb, Xoa, Urb, Urb^Eb, Urb, Xoa, Urb, Urb^Eb, Urb, Exos^Cov, Exos^Cov, Uu, Uh^Qhh, Xoa, Xu
Xu, Xue, Xu, Wwf, Wwg, Wwf, Xu, Xue, Xu, Xu, Xu, Tb, Xoa, Uu^Es, Urb, Urb, Uh, Uu^Es, Uu, Uu, Uu, Uu, Uu^Es, Uu, Uh, Exos^Cov, Uh, Exos^Cov, Uu, Uu^Es, Xoa, Xu
Xu, Xu, Wwf, Wwf, Wog, Wwf, Xu, Xu, Xu, Xu, Xu, Xu, Xoa, Uu, Urb^Edt, Uu^Em, Qxu, Qxu, Xoa, Uh, Xoa, Xoa, Xoa, Xoa, Xoa, Uh, Xoa, Xoa, Xoa, Xoa, Xu, Xu
Wwrg, Wwg^Es, Wog, Wog, Xu, Xu, Xu, Xu, Xu, Xu, Xu, Xu, Uh^Qhh, Uh^Qhh, Urb^Em, Qxu, Qxu, Xoa, Xu, Xu, Xu, Xu, Xu, Xu, Xu, Xu, Xu, Xu, Xu, Xu, Xu, Xu
Wwg, Wog, Xu, Xu, Xu, Xu, Xu, Xu, Xu, Xu, Xu, Xu, Uh^Qhh, Uu^Eb, Urb^Tf, Uu^Eb, Xu, Xu, Xu, Xu, Xu, Xu, Xu, Xu, Xu, Xu, Xu, Xu, Xu, Xu, Xu, Xu
Xu, Xu, Xu, Xu, Xu, Xu, Xu, Xu, Xu, Xu, Xu, Xu, Qxu, Qxu, Urb^Em, Uu^Tf, Qxu, Qxu, Qxu, Qxu, Qxu, Qxu, Xu, Xu, Xu, Xu, Xu, Xu, Xu, Xu, Xu, Xu
Xu, Xu, Xu, Xu, Xu, Xu, Xu, Xu, Xu, Xu, Xu, Tb, Uh^Qhh, Qxu, Uu^Tf, Urb^Em, Urb^Edt, Urb, Urb, Qxu, Tb, Xu, Xu, Xu, Xu, Xu, Xu, Xu, Xu, Xu, Xu, Xu
Xu, Xu, Xu, Xu, Xu, Xu, Xu, Xu, Xu, Xu, Xu, Xu, Xu, Qxu, Uu^Tf, Uu^Es, Tb^Eb, Qxu, Uu^Em, Urb, Urb, Uh^Qhh, Uh^Qhh, Qxu, Xu, Xu, Xu, Xu, Xu, Xu, Xu, Xu
Xu, Xu, Xu, Xu, Xu, Xu, Xu, Xu, Xu, Xu, Xu, Xu, Xu, Uu^Tf, Uu^Tf, Qxu, Qxu, Qxu, Qxu, Uu^Es, Uu^Eb, Urb^Edb, Uu^Eb, Qxu, Uu^Tf, Xu, Xu, Xu, Xu, Xu, Xu, Xu
Xu, Xu, Xu, Xu, Xu, Xu, Xu, Xu, Xu, Xu, Xu, Xu, Xu, Xu, Xu, Xu, Xu, Qxu, Uh^Qhh, Qxu, Qxu, Urb, Qxu, Qxu, Qxu, Xu, Xu, Xu, Xu, Xu, Xu, Xu
Xu, Xu, Xu, Xu, Xu, Xu, Xu, Xu, Xu, Xu, Xu, Xu, Xu, Xu, Xu, Xu, Xu, Xu, Xu, Tb, Uu^Es, Urb^Edt, Uu^Qhh, Tb, Uu^Tf, Qxu, Xu, Xu, Xu, Xu, Xu, Xu
Xu, Xu, Xu, Xu, Xu, Xu, Xu, Xu, Xu, Xu, Xu, Xu, Xu, Xu, Xu, Xu, Xu, Xu, Uh, Tb, Uu^Eb, Urb, Uu^Eb, Uu^Tf, Uu^Tf, Xu, Xu, Xu, Xu, Xu, Xu, Xu
Uu^Tf, Xu, Xue, Xue, Xue, Xue, Xu, Xu, Tb, Xu, Uu^Qhh, Xu, Tb, Xu, Xu, Xu, Xu, Xu, Uh, Uu^Es, Uu^Em, Urb^Em, Qxu, Qxu, Uu^Tf, Xu, Xu, Xu, Xu, Xu, Xu, Xu
Uu^Tf, Uu^Tf, Ur, Uhe^Qhh, Uue^Tf, Uu^Tf, Uu^Vu, Uu, Ur^Es, Ur^Em, Uu^Es, Uh^Qhh, Uu^Es, Ur, Uu^Tf, Xu, Ur, Ur^Em, Qxu, Ur, Tb, Urb, Urb, Qxu, Tb, Xu, Xu, Xu, Xu, Xu, Xu, Xu
Uu, Uu^Cov, Ur^Kov, Ur, Uu^Es, Ur^Edt, Ur, Ur, Uu^Tf, Ur^Tf, Uu, Ur^Edt, Uu^Vu, Ur, Ur, Uu^Es, Qxu, Qxu, Ur, Qxu, Ur^Em, Ur, Uu^Qhh, Urb^Edt, Urb, Uu^Qhh, Xu, Xu, Xu, Xu, Xu, Xu
Uu, Ur^Cov, Uu^Cov, Uh^Cov, Xu, Ur, Xu, Uh^Qhh, Xu, Uu^Tf, Xu, Uu, Xu, Uue^Qhh, Uhe^Qhh, Ur, Uh^Qhh, Ur^Em, Uu^Qhh, Uh^Qhh, Xu, Ur, Xu, Uu^Eb, Urb^Dr, Uu^Eb, Xu, Xu, Xu, Xu, Xu, Xu
Xu, Xu, Xu, Xu, Xu, Xu, Xu, Xu, Xu, Xu, Xu, Xu, Xu, Xue, Xue, Xue, Xu, Ur, Xu, Xu, Xu, Xu, Xu, Uu^Dr, Mdd^Xo, Uu^Dr, Xu, Xu, Xu, Xu, Xu, Xu
Xu, Xu, Xu, Xu, Xu, Xu, Xu, Xu, Xu, Xu, Xu, Xu, Xu, Xu, Xu, Xu, Xu, Xu, Xu, Xu, Xu, Xu, Xu, Mdd^Xo, Mdd^Xo, Mdd^Xo, Xu, Xu, Xu, Xu, Xu, Xu
