Aa^Qhh, Aa^Qhh, Aa^Qhh, Gd^Qhh, Aa^Qhh, Aa^Qhh, Wo, Hhd, Ms, Hhd, Hhd, Ha^Fdw, Ha^Fpa, Gd, Gd^Es, Gd, Re, Aa, Aa^Esa, Gd, Hhd, Hhd, Ms^Xm, Ms, Ms, Hhd, Hhd, Gd, Aa^Fpa, Gd, Gd^Fmf, Gd^Fmf, Aa^Fdw
Aa^Qhh, Aa^Qhh, Aa^Qhh, Aa^Qhh, Cea^Qhh, Aa^Qhh, Wog, Ha, Ms^Xm, Ms, Ha^Fpa, Ha^Fpa, Aa^Fpa, Aa^Fpa, Gd^Es, Aa, Re, Aa^Esa, Aa^Esa, Gd, Ha, Ms, Ms, Ms, Hhd^Fdw, Hhd^Fdw, Aa^Fmf, Gd^Fpa, Aa^Fpa, Gd^Fdw, Aa^Fpa, Aa^Fmf, Gd^Fdw
Aa^Qhh, Aa^Qhh, Aa^Vct, Cea^Qhh, Kea, Cea^Qhh, Ww, Gd^Vct, Hhd, Ms, Hhd^Fdw, Aa^Fmf, Gd^Fmf, Aa^Fpa, Aa^Fdw, Aa, Re, Gd^Esa, Aa^Esa, Aa, Aa, Ha, Ha, Ha^Fdw, Aa^Fdw, Aa^Fmf, Aa^Fmf, Aa^Fdw, Aa^Fpa, Aa^Fdw, Gd^Fpa, Gd^Fdw, Aa
Aa^Qhh, Aa, Aa, Cea, Cea, Cea^Qhh, Ww, Aa, Aa^Esa, Ms, Aa^Fpa, Aa^Fmf, Aa^Fmf, Gd^Fmf, Aa^Fdw, Aa^Fdw, Aa^Esa, Aa^Fpa, Aa^Fdw, Aa, Aa, Hhd, Ha, Ha^Fdw, Gd^Fdw, Gd^Fmf, Aa^Fmf, Aa^Fdw, Gd^Fdw, Aa^Fdw, Aa^Fdw, Gll, Aa
Ms, Aa^Esa, Gd^Es, Rd, Aa^Vct, Aa^Qhh, Wwg, Aa, Aa^Esa, Ms, Ms^Xm, Ms, Gd^Fdw, Aa^Fdw, Aa, Aa, Re^Esa, Aa^Fdw, Aa^Fdw, Aa, Aa, Gd, Aa^Fpa, Aa^Fdw, Aa^Fdw, Aa^Fdw, Aa^Fpa, Gd^Fdw, Aa^Esa, Aa^Esa, Aa, Aa, Aa^Esa
Ms, Ms^Xm, Ms, Aa, Aa^Esa, Aa^Qhh, Wog, Aa, Ha, Ms, Ms, Ms, Ha, Gll, Gd^Edt, Aa, Ha, Re, Aa^Fdw, Gll^Fdw, Aa^Fpa, Aa^Fpa, Aa^Feta, Aa^Fmf, Gd^Fdw, Aa^Fpa, Aa^Fpa, Aa, Aa, Aa^Esa, Aa^Vaa, Aa^Esa, Aa
Ha^Fmf, Ms, Ha, Ha, Ha^Fp, Aa^Qhh, Aa^Qhh, Wo, Aa^Esa, Ha, Ms, Ha, Hhd, Aa^Vca, Gd, Ha, Ha, Re, Aa^Fdw, Aa^Fdw, Gll^Fdw, Aa^Fpa, Aa^Fpa, Aa^Fmf, Gd^Fdw, Gll^Fdw, Aa, Aa, Ms^Xm, Aa, Aa, Aa^Esa, Gll
Hhd^Fmf, Hhd^Fmf, Aa^Fmf, Hhd^Fp, Ha^Fp, Hhd^Fp, Aa^Qhh, Wo, Aa^Vaa, Aa^Esa, Ms, Ms, Hhd, Aa, Aa, Aa, Aa^Edt, Re, Gll^Fdw, Aa^Fdw, Aa^Fdw, Aa^Fpa, Aa^Fdw, Aa^Fdw, Aa, Aa, Ms, Hhd, Ms, Ms, Aa, Aa, Aa
Gd^Fmf, Gd^Fmf, Aa^Fmf, Aa^Fdw, Gd^Fdw, Aa^Fdw, Aa^Qhh, Wog, Wog, Wwg, Ww, Hhd, Aa, Gd, Ha, Aa, Aa, Re, Re, Aa^Fdw, Aa^Fmf, Aa^Fdw, Aa^Fdw, Aa^Fdw, Hhd, Ha, Ha, Ms, Hhd, Ms, Ha, Gd^Es, Aa
Gd^Fdw, Aa^Fdw, Aa^Fdw, Gd^Fmf, Aa^Fdw, Aa^Fdw, Aa, Rd^Qhh, Hhd^Qhh, Hhd^Qhh, Hhd^Qhh, Wwg, Wog, Ha, Ha, Aa, Aa, Gd^Esa, Re^Esa, Aa^Fmf, Aa^Fmf, Aa^Fmf, Aa^Fdw, Aa^Fdw, Hhd, Ha, Ai, Ai, Ai, Ha, Ha, Hhd, Aa
Aa, Aa^Fdw, Rd, Aa^Fdw, Aa, Aa, Aa^Esa, Hhd, Ms^Xm, Hhd, Ha, Aa^Qhh, Aa^Qhh, Wo, Wog, Gd, Ww, Aa^Esa, Wwf, Aa, Aa, Gd^Fmf, Aa^Fdw, Gd, Ai, Ai, Ai, Ai, Ai, Ai, Ai, Ai, Ai
Aa, Rd, Rd^Es, Aa, Aa, Gll, Ha^Esa, Hhd^Esa, Ms, Ms, Hhd^Esa, Hhd, Aa, Aa^Qhh, Aa^Qhh, Wwg, Aa^Qhh, Wwg, Wwf, Wwg, Wog, Aa, Aa^Esa, Ai, Ai, Ai, Wwg, Sm, Sm, Sm^Vhs, Sm, Ai, Ai
Aa, Aa, Aa^Esa, Gd, Aa, Hhd, Ha^Esa, Ms^Esa, Ms, Ms^Esa, Ha^Esa, Gd^Es, Aa, Aa, Ha, Aa^Qhh, Gd^Es, Aa^Qhh, Re^Qhh, Aa^Qhh, Hhd^Qhh, Wog, Ww, Ww, Wog, Wo, Wog, Wwg, Wo, Wwg, Wwg, Wwg, Wo
Aa^Esa, Aa^Esa, Aa^Esa, Aa, Aa, Hhd, Aa, Hhd, Ha, Ha, Hhd, Aa, Aa, Gll, Aa, Aa, Aa, Aa^Vca, Re, Ha, Md, Md^Qhh, Md^Qhh, Gd^Qhh, Hhd^Qhh, Ai^Qhh, Sm, Wwr, Wog, Wog, Wo, Ww, Ww
Aa, Aa, Gd, Aa^Esa, Aa^Esa, Gd, Gd, Gd, Ha, Hhd, Aa, Aa, Aa^Fdw, Aa^Fmf, Aa^Fdw, Aa, Hhd, Aa, Re, Aa, Hhd, Md, Ms, Ha, Hhd, Ai^Qhh, Sm^Vhs, Sm, Wo, Wog, Cme, Kme, Ww
Aa^Qhh, Aa, Aa, Aa, Aa, Aa, Aa, Aa, Aa, Aa, Aa, Gd^Edt, Gd^Fp, Aa^Fdw, Aa^Fdw, Aa^Fp, Aa, Aa, Gd, Re, Aa^Fdw, Ha^_mh, Ha, Hhd, Gd^Esa, Ai^Qhh, Ai^Qhh, Sm, Wwg, Wwg, Kme, Cme, Sm
Aa^Qhh, Aa^Qhh, Ai^Qhh, Aa^Vaa, Ai^Qhh, Ai^Qhh, Ai^Qhh, Aa, Gd^Edt, Aa, Gll, Gll, Gd^Fp, Aa^Fp, Gd^Fdw, Gd^Fdw, Gd^Fdw, Aa^Esa, Aa^Edt, Re^Esa, Aa^Fdw, Ha^Fdf, Aa^Fdw, Aa^Fp, Aa^Fp, Ai, Ai^Qhh, Sm, Ww, Ww^Vhs, Wwr, Sm, Sm^Vhs
Ai^Qhh, Ai^Qhh, Wwg, Ai^Qhh, Ww, Ai^Qhh, Ww, Ai^Qhh, Ai^Qhh, Ai^Qhh, Ai^Qhh, Ai^Qhh, Ai^Qhh, Gd^Fp, Gd^Fdw, Gd^Fmf, Aa^Fmf, Aa, Hhd, Re, Re, Hhd^Fmf, Gd^Fmf, Aa^Fdw, Aa^Fp, Aa, Ai^Qhh, Ww, Wog, Wo, Sm, Sm, Ai
Ww, Wwg, Wog, Ww^Es, Ww, Wo, Wog, Wo, Wwg, Ww, Wo, Ww, Ww, Ai^Qhh, Ai^Qhh, Gd^Fmf, Aa^Fmf, Ha^Fdf, Ha^Fdw, Ha^Fdw, Aa, Re, Re, Aa^Fdw, Aa^Fdw, Aa, Ai^Qhh, Wwg, Wog, Wwg, Ai, Ai, Ai
Wo, Wog, Wwg, Wwg, Md^Qhh, Ms^Qhh, Aa^Qhh, Ww^Es, Aa^Qhh, Wwg, Wwg, Wog, Wog, Ww^Es, Ai^Qhh, Ai, Aa^Fdw, Aa^Fdw, Aa^Fdw, Gll, Aa^Vca, Aa, Gd^Esa, Re, Aa, Ai^Qhh, Wwg, Wwg, Ww, Ww, Ai, Ai, Aa
Ww, Wwg, Ha^Qhh, Md^Qhh, Hhd, Md^Esa, Gs^Es, Aa^Qhh, Aa, Aa^Qhh, Aa^Qhh, Ww, Ww, Wwg, Wog, Ai^Qhh, Ai^Qhh, Aa^Fdw, Aa^Fmf, Aa, Aa, Aa, Aa, Re, Ai^Qhh, Ai^Qhh, Ww, Wo, Ai, Ai, Aa, Aa, Gs^Esa
Aa, Hhd^Qhh, Hh^Esa, Ha, Re^Esa, Re, Re^Esa, Aa, Md, Aa, Ms^Esa, Aa^Qhh, Aa^Qhh, Ww, Wog, Wo, Ai^Qhh, Aa, Ai^Qhh, Aa, Ai^Qhh, Ai^Qhh, Ai^Qhh, Re^Qhh, Wwf, Ww, Wo, Wog, Ai, Aa, Gs^Esa, Gs^Esa, Hhd
Gs^Qhh, Aa^Qhh, Re, Re, Re, Re, Aa, Gg^Esa, Gd, Md^Esa, Md, Hhd, Gs^Esa, Aa^Qhh, Wwg, Wwg, Ai^Qhh, Ai^Qhh, Ww, Ai^Qhh, Wog, Ww, Wwg, Wwf, Wwf, Wwf, Ai, Ai, Hhd^Esa, Ha, Ha, Ha, Hhd
Gll^Fmw, Gll, Gs^Es, Re, Gd, Re, Re, Gd, Gd^Esa, Hhd, Hh, Md, Gs^Es, Aa^Qhh, Aa^Qhh, Wo, Wog, Ww, Ww^Es, Wo, Wog, Wo, Ai, Wwf, Ai, Re^Es, Re, Aa^Vca, Aa, Hhd^Esa, Hh, Hh, Hhd
Gll^Fmw, Gll^Fmw, Gll^Fmf, Gs^Esa, Gd^Vo, Gd^Edt, Ket, Ket^Vct, Ket, Gd^Edb, Gd^Vo, Gll, Gll^Fmf, Gll^Fmf, Gll^Qhhf, Ww, Ww, Wog, Wwg, Wwg, Ai, Ai, Gs^Esa, Aa, Aa, Aa^Edt, Re, Aa, Ce^Esa, Ce^Esa, Hh, Hh, Gs
Gll^Fmf, Gll^Fmw, Gll^Fmf, Gll, Gd, Gd, Ket, Ce, Ket, Gd, Gs^Esa, Gll, Gll^Fmf, Gll^Fmf, Gll^Fmw, Gll^Qhhf, Hhd^Qhh, Ai, Ai, Ai, Gs^Es, Gll, Gll^Fmf, Gll^Fma, Gs^Esa, Aa, Re, Gs^Esa, Ce, Ke, Hhd, Hhd, Gs
Gll^Fmf, Gll^Fmf, Gll, Gs^Es, Gg^Esa, Hhd, Gd, Gd^Edt, Gs, Re, Re, Gll, Re, Gll^Fmf, Hhd, Hhd, Hh^Qhh, Aa, Aa, Aa, Re, Gll^Fmw, Gll^Fmw, Gll^Fmw, Re, Re, Gs, Gs, Gs, Ce, Gs^Vct, Gs, Gs
Gll^Fmf, Gll^Fmf, Md, Hhd, Hh, Hh, Gs, Gd^Es, Gd^Vo, Gs, Gs^Esa, Re, Gs, Re, Re, Hh, Re^Qhh, Gs^Esa, Re, Re, Hhd, Re, Re, Re, Aa, Gs^Es, Gs, Gs^Vct, Hhd, Gs, Gs, Gs^Es, Gs
Gs, Gll, Md, Hhd, Hhd, Hh, Gs^Es, Gs, Gll, Gll, Gll^Fmw, Gll^Fmw, Gll^Fmw, Gll^Fmf, Gll^Fmw, Re^_mh, Gs^Qhh, Re, Gll^Fmw, Gll^Fmf, Hhd, Hh, Aa, Aa, Aa, Gs, Gs, Hhd, Hh, Hhd, Hhd, Gs, Gs
Gs, Gs, Gs, Ms, Gs, Gs, Gs, Gll^Fmf, Gll^Fmf, Gll^Fmf, Gll^Fmf, Gll^Fmw, Gll^Fmf, Gll^Fmf, Gll^Fmf, Gs, Gs^Qhh, Gs, Gs, Gll^Fmw, Gs, Hhd, Gs, Aa, Aa, Aa, Gs, Hh, Hhd, Hh, Hhd, Hhd, Gs
