Aa, Aa, Aa, Gd, Aa^Edt, Aa, Wo, Hhd, Ms, Hhd, Hhd, Ha^Fdw, Ha^Fpa, Gd, Gd^Es, Gd, Re, Aa, Aa^Esa, Gd, Hhd, Hhd, Ms^Xm, Ms, Ms, Hhd, Hhd, Gd, Aa^Fpa, Gd, Gd^Fmf, Gd^Fmf, Aa^Fdw
Aa, Aa, Aa, Aa, Cea, Aa, Wog, Ha, Ms^Xm, Ms, Ha^Fpa, Ha^Fpa, Aa^Fpa, Aa^Fpa, Gd^Es, Aa, Re, Aa^Esa, Aa^Esa, Gd, Ha, Ms, Ms, Ms, Hhd^Fdw, Hhd^Fdw, Aa^Fmf, Gd^Fpa, Aa^Fpa, Gd^Fdw, Aa^Fpa, Aa^Fmf, Gd^Fdw
Aa, Aa^Edt, Aa^Vct, Cea, Kea, Cea, Ww, Gd^Vct, Hhd, Ms, Hhd^Fdw, Aa^Fmf, Gd^Fmf, Aa^Fpa, Aa^Fdw, Aa, Re, Gd^Esa, Aa^Esa, Aa, Aa, Ha, Ha, Ha^Fdw, Aa^Fdw, Aa^Fmf, Aa^Fmf, Aa^Fdw, Aa^Fpa, Aa^Fdw, Gd^Fpa, Gd^Fdw, Aa
Aa, Aa, Aa, Cea, Cea, Cea, Ww, Aa, Aa^Esa, Ms, Aa^Fpa, Aa^Fmf, Aa^Fmf, Gd^Fmf, Aa^Fdw, Aa^Fdw, Aa^Esa, Aa^Fpa, Aa^Fdw, Aa, Aa, Hhd, Ha, Ha^Fdw, Gd^Fdw, Gd^Fmf, Aa^Fmf, Aa^Fdw, Gd^Fdw, Aa^Fdw, Aa^Fdw, Gll, Aa
Ms, Aa, Gd^Es, Rd, Aa^Vct, Aa, Wwg, Aa, Aa^Esa, Ms, Ms^Xm, Ms, Gd^Fdw, Aa^Fdw, Aa, Aa, Re^Esa, Aa^Fdw, Aa^Fdw, Aa, Aa, Gd, Aa^Fpa, Aa^Fdw, Aa^Fdw, Aa^Fdw, Aa^Fpa, Gd^Fdw, Aa^Esa, Aa^Esa, Aa, Aa, Aa^Esa
Ms, Ms^Xm, Ms, Aa, Aa, Aa, Wog, Aa, Ha, Ms, Ms, Ms, Ha, Gll, Gd^Edt, Aa, Ha, Re, Aa^Fdw, Gll^Fdw, Aa^Fpa, Aa^Fpa, Aa^Feta, Aa^Fmf, Gd^Fdw, Aa^Fpa, Aa^Fpa, Aa, Aa, Aa^Esa, Aa^Vaa, Aa^Esa, Aa
Ha^Fmf, Ms, Ha, Ha, Ha^Fp, Aa, Aa, Wo, Aa^Esa, Ha, Ms, Ha, Hhd, Aa^Vca, Gd, Ha, Ha, Re, Aa^Fdw, Aa^Fdw, Gll^Fdw, Aa^Fpa, Aa^Fpa, Aa^Fmf, Gd^Fdw, Gll^Fdw, Aa, Aa, Ms^Xm, Aa, Aa, Aa^Esa, Gll
Hhd^Fmf, Hhd^Fmf, Aa^Fmf, Hhd^Fp, Ha^Fp, Hhd^Fp, Aa^Edt, Wo, Aa^Vaa, Aa^Esa, Ms, Ms, Hhd, Aa, Aa, Aa, Aa^Edt, Re, Gll^Fdw, Aa^Fdw, Aa^Fdw, Aa^Fpa, Aa^Fdw, Aa^Fdw, Aa, Aa, Ms, Hhd, Ms, Ms, Aa, Aa, Aa
Gd^Fmf, Gd^Fmf, Aa^Fmf, Aa^Fdw, Gd^Fdw, Aa^Fdw, Aa, Wog, Wog, Wwg, Ww, Hhd, Aa, Gd, Ha, Aa, Aa, Re, Re, Aa^Fdw, Aa^Fmf, Aa^Fdw, Aa^Fdw, Aa^Fdw, Hhd, Ha, Ha, Ms, Hhd, Ms, Ha, Gd^Es, Aa
Gd^Fdw, Aa^Fdw, Aa^Fdw, Gd^Fmf, Aa^Fdw, Aa^Fdw, Aa, Rd, Hhd, Hhd, Hhd, Wwg, Wog, Ha, Ha, Aa, Aa, Gd^Esa, Re^Esa, Aa^Fmf, Aa^Fmf, Aa^Fmf, Aa^Fdw, Aa^Fdw, Hhd, Ha, Ai, Ai, Ai, Ha, Ha, Hhd, Aa
Aa, Aa^Fdw, Rd, Aa^Fdw, Aa, Aa, Aa^Esa, Hhd, Ms^Xm, Hhd, Ha, Aa, Aa, Wo, Wog, Gd, Ww, Aa^Esa, Wwf, Aa, Aa, Gd^Fmf, Aa^Fdw, Gd, Ai, Ai, Ai, Ai, Ai, Ai, Ai, Ai, Ai
Aa, Rd, Rd^Es, Aa, Aa, Gll, Ha^Esa, Hhd^Esa, Ms, Ms, Hhd^Esa, Hhd, Aa, Aa^Esa, Aa, Wwg, Aa, Wwg, Wwf, Wwg, Wog, Aa, Aa^Esa, Ai, Ai, Ai, Wwg, Sm, Sm, Sm^Vhs, Sm, Ai, Ai
Aa, Aa, Aa^Esa, Gd, Aa, Hhd, Ha^Esa, Ms^Esa, Ms, Ms^Esa, Ha^Esa, Gd^Es, Aa, Aa, Ha, Aa, Gd^Es, Aa, Re, Aa, Hhd, Wog, Ww, Ww, Wog, Wo, Wog, Wwg, Wo, Wwg, Wwg, Wwg, Wo
Aa^Esa, Aa^Esa, Aa^Esa, Aa, Aa, Hhd, Aa, Hhd, Ha, Ha, Hhd, Aa, Aa, Gll, Aa, Aa, Aa, Aa^Vca, Re, Ha, Md, Md, Md, Gd, Hhd, Ai, Sm, Wwr, Wog, Wog, Wo, Ww, Ww
Aa, Aa, Gd, Aa^Esa, Aa^Esa, Gd, Gd, Gd, Ha, Hhd, Aa, Aa, Aa^Fdw, Aa^Fmf, Aa^Fdw, Aa, Hhd, Aa, Re, Aa, Hhd, Md, Ms, Ha, Hhd, Ai, Sm^Vhs, Sm, Wo, Wog, Cme, Kme, Ww
Aa, Aa, Aa, Aa, Aa, Aa, Aa, Aa, Aa, Aa, Aa, Gd^Edt, Gd^Fp, Aa^Fdw, Aa^Fdw, Aa^Fp, Aa, Aa, Gd, Re, Aa^Fdw, Ha, Ha, Hhd, Gd^Esa, Ai, Ai, Sm, Wwg, Wwg, Kme, Cme, Sm
Aa, Aa, Ai, Aa^Vaa, Ai, Ai, Ai, Aa, Gd^Edt, Aa, Gll, Gll, Gd^Fp, Aa^Fp, Gd^Fdw, Gd^Fdw, Gd^Fdw, Aa^Esa, Aa^Edt, Re^Esa, Aa^Fdw, Ha^Fdf, Aa^Fdw, Aa^Fp, Aa^Fp, Ai, Ai, Sm, Ww, Ww^Vhs, Wwr, Sm, Sm^Vhs
Ai, Ai, Wwg, Ai, Ww, Ai, Ww, Ai, Ai, Ai, Ai, Ai, Ai, Gd^Fp, Gd^Fdw, Gd^Fmf, Aa^Fmf, Aa, Hhd, Re, Re, Hhd^Fmf, Gd^Fmf, Aa^Fdw, Aa^Fp, Aa, Ai, Ww, Wog, Wo, Sm, Sm, Ai
Ww, Wwg, Wog, Ww^Es, Ww, Wo, Wog, Wo, Wwg, Ww, Wo, Ww, Ww, Ai, Ai, Gd^Fmf, Aa^Fmf, Ha^Fdf, Ha^Fdw, Ha^Fdw, Aa, Re, Re, Aa^Fdw, Aa^Fdw, Aa, Ai, Wwg, Wog, Wwg, Ai, Ai, Ai
Wo, Wog, Wwg, Wwg, Md^Esa, Ms, Aa, Ww^Es, Aa, Wwg, Wwg, Wog, Wog, Ww^Es, Ai, Ai, Aa^Fdw, Aa^Fdw, Aa^Fdw, Gll, Aa^Vca, Aa, Gd^Esa, Re, Aa, Ai, Wwg, Wwg, Ww, Ww, Ai, Ai, Aa
Ww, Wwg, Ha, Md, Hhd, Md^Esa, Gs^Es, Aa, Aa, Aa, Aa, Ww, Ww, Wwg, Wog, Ai, Ai, Aa^Fdw, Aa^Fmf, Aa, Aa, Aa, Aa, Re, Ai, Ai, Ww, Wo, Ai, Ai, Aa, Aa, Gs^Esa
Ww, Hhd, Hh^Esa, Ha, Re^Esa, Re, Re^Esa, Aa, Md, Aa, Ms^Esa, Aa, Aa, Ww, Wog, Wo, Ai, Aa, Ai, Aa, Ai, Ai, Ai, Re, Wwf, Ww, Wo, Wog, Ai, Aa, Gs^Esa, Gs^Esa, Hhd
Gs, Aa, Re, Re, Re, Re, Aa, Gg^Esa, Gd, Md^Esa, Md, Hhd, Gs^Esa, Aa, Wwg, Wwg, Ai, Ai, Ww, Ai, Wog, Ww, Wwg, Wwf, Wwf, Wwf, Ai, Ai, Hhd^Esa, Ha, Ha, Ha, Hhd
Gll^Fmw, Gll, Gs^Es, Re, Gd, Re, Re, Gd, Gd^Esa, Hhd, Hh, Md, Gs^Es, Aa, Aa, Wo, Wog, Ww, Ww^Es, Wo, Wog, Wo, Ai, Wwf, Ai, Re^Es, Re, Aa^Vca, Aa, Hhd^Esa, Hh, Hh, Hhd
Gll^Fmw, Gll^Fmw, Gll^Fmf, Gs^Esa, Gd^Vo, Gd^Edt, Ket, Ket^Vct, Ket, Gd^Edb, Gd^Vo, Gll, Gll^Fmf, Gll^Fmf, Gll^Fmf, Ww, Ww, Wog, Wwg, Wwg, Ai, Ai, Gs^Esa, Aa, Aa, Aa^Edt, Re, Aa, Ce^Esa, Ce^Esa, Hh, Hh, Gs
Gll^Fmf, Gll^Fmw, Gll^Fmf, Gll, Gd, Gd, Ket, Ce, Ket, Gd, Gs^Esa, Gll, Gll^Fmf, Gll^Fmf, Gll^Fmw, Gll^Fmw, Hhd, Ai, Ai, Ai, Gs^Es, Gll, Gll^Fmf, Gll^Fma, Gs^Esa, Aa, Re, Gs^Esa, Ce, Ke, Hhd, Hhd, Gs
Gll^Fmf, Gll^Fmf, Gll, Gs^Es, Gg^Esa, Hhd, Gd, Gd^Edt, Gs, Re, Re, Gll, Re, Gll^Fmf, Hhd, Hhd, Hh, Aa, Aa, Aa, Re, Gll^Fmw, Gll^Fmw, Gll^Fmw, Re, Re, Gs, Gs, Gs, Ce, Gs^Vct, Gs, Gs
Gll^Fmf, Gll^Fmf, Md, Hhd, Hh, Hh, Gs, Gd^Es, Gd^Vo, Gs, Gs^Esa, Re, Gs, Re, Re, Hh, Re, Gs^Esa, Re, Re, Hhd, Re, Re, Re, Aa, Gs^Es, Gs, Gs^Vct, Hhd, Gs, Gs, Gs^Es, Gs
Gs, Gll, Md, Hhd, Hhd, Hh, Gs^Es, Gs, Gll, Gll, Gll^Fmw, Gll^Fmw, Gll^Fmw, Gll^Fmf, Gll^Fmw, Re, Gs^Es, Re, Gll^Fmw, Gll^Fmf, Hhd, Hh, Aa, Aa, Aa, Gs, Gs, Hhd, Hh, Hhd, Hhd, Gs, Gs
Gs, Gs, Gs, Ms, Gs, Gs, Gs, Gll^Fmf, Gll^Fmf, Gll^Fmf, Gll^Fmf, Gll^Fmw, Gll^Fmf, Gll^Fmf, Gll^Fmf, Gs, Gs, Gs, Gs, Gll^Fmw, Gs, Hhd, Gs, Aa, Aa, Aa, Gs, Hh, Hhd, Hh, Hhd, Hhd, Gs
