Gs^Fms, Gs^Fms, Gs^Fms, Gs^Fms, Gs^Fms, Gs^Fms, Gs^Fms, Gs^Fms, Gs^Fms, Hh, Hh^Fms, Hh^Fms, Gs^Fms, Gs^Fms, Gs^Fms, Gs^Fms, Gs^Fms, Gs^Fms, Gs^Fms, Gs^Fms, Gs^Fms, Gs^Fms, Gs^Fms, Gs^Fms, Gll^Fmw, Gs^Fms, Gs^Fms, Gs^Fms, Gs^Fms, Gs^Fms, Gs^Fms, Ww, Ww, Ww, Wog, Ww, Wog, Wog, Wo, Wo, Wo, Wo, Wo, Wo
Gs^Fms, Gs^Fms, Gs^Fds, Gs^Fds, Gs^Fp, Gs^Fds, Gs^Fds, Gs^Fds, Hh^Fds, Hh^Fms, Hh^Fms, Hh^Fms, Gs^Fms, Gs^Fms, Gs^Fds, Gs^Fds, Gs^Fds, Gs^Fds, Gs^Fds, Gs^Fds, Gs^Fds, Gs^Fds, Gs^Fds, Gs^Fds, Gs^Fds, Gs^Fms, Gs^Fds, Gs^Fms, Gs^Fds, Gs^Fms, Gs^Fms, Ww, Ww, Wog, Wog, Wog, Wo, Wo, Wo, Wo, Wo, Wo, Wo, Wo
Gs^Fds, Gs^Fds, Gs^Fp, Gs^Fms, Gs^Fp, Gs^Fms, Hh, Hh^Fds, Ms, Hh^Fmw, Hh^Fmw, Hh^Fds, Gs^Fms, Gs^Fds, Gs^Fds, Gll^Fmw, Gs^Fds, Gs^Fds, Gs^Fms, Gs^Fds, Gs^Fms, Gs^Fds, Gs^Fms, Gs^Fds, Gs^Fms, Gs^Fds, Gs^Fp, Gs^Fds, Gs^Fp, Gs^Fms, Gs^Fms, Ww, Ww, Ww, Wog, Wo, Wo, Wo, Wo, Wo, Wo, Wo, Wo, Wo
Gs^Fds, Gs^Fds, Gs^Fp, Gs^Fp, Gs^Fms, Gs^Fms, Gs, Mm, Mm, Mm, Gs^Fms, Gs^Fms, Gs^Fms, Gs^Fds, Gs^Fds, Gs^Fds, Gs^Fms, Gs^Fms, Gg^Efm, Gs^Fms, Gs, Gs^Fms, Gs^Fms, Gs^Fms, Gs^Fms, Gs^Fms, Gs^Fp, Gs^Fp, Gs^Fds, Gs^Fms, Gs^Fms, Gs^Fms, Ww, Ww, Ww, Wog, Wo, Wo, Wo, Wo, Wo, Wo, Wo, Wo
Gs^Fms, Gs^Fp, Gs^Fms, Gs^Fmw, Aa, Gs^Esa, Co^Vct, Hh, Hh^Fp, Mm, Hh, Gs^Fms, Gs^Fms, Gs^Fp, Gs^Fp, Gs^Fp, Gs^Fms, Gs, Gg^Efm, Gg, Gs^Es, Gg^Edb, Gs^Esa, Gd, Gs^Fmw, Gs^Fp, Gs^Fds, Gs^Fds, Gs^Fds, Gs^Fms, Gs^Fms, Gs^Fms, Ds, Ww, Ww, Wog, Wog, Wo, Wo, Wo, Wo, Wo, Wo, Wo
Gs, Gs^Fms, Gs, Gs, Hh, Hh^Esa, Hh, Hhd, Hhd, Hhd, Hh, Gs, Aa^Esa, Gs^Fp, Gs^Fms, Gs^Fms, Gd, Gs^Efm, Ce, Ket, Ce, Re^Esa, Aa, Aa, Gs^Esa, Gs^Fp, Gs^Fms, Gs^Fds, Gs^Fms, Gs^Fms, Gd, Gg, Ds, Ww, Ww, Wog, Wo, Wo, Wo, Wo, Wo, Wo, Wo, Wo
Gs, Gs^Edb, Gs, Hh, Gs, Gs^Edb, Hh^Fp, Hh, Gs, Wo, Gg, Hh, Gs, Gs^Esa, Gs, Gd, Ce, Ce, Ce, Cv, Ce, Ce, Gs^Vct, Aa, Gs, Gs^Fms, Gs^Fms, Gs^Fds, Gs^Fms, Gd, Aa^Esa, Gg, Gs^Esa, Ww, Ww, Ww, Wo, Wo, Wo, Wo, Wo, Wo, Wo, Wo
Gs, Aa, Gs^Esa, Hh, Gs^Esa, Aa, Hh, Hh, Gs, Ww^Ewl, Wo, Hh, Gs^Esa, Gs, Gs^Vct, Re, Re, Ce, Ce, Ce, Gs^Vct, Gs^Vct, Gs^Vct, Gs^Vct, Gg, Gs^Fms, Gs^Fms, Gs^Fms, Gll^Fmw, Gd, Aa^Es, Aa, Gs^Esa, Ww, Ww, Ww, Wog, Wog, Wog, Wo, Wo, Wo, Wo, Wo
Gs, Aa, Aa, Gs^Esa, Aa, Gs^Esa, Hh, Gs, Gd, Gs, Wo, Aa, Aa, Gs^Vct, Gs^Vct, Gs^Vct, Gs^Vct, Re, Re, Re, Re, Gs^Vct, Gs^Efm, Gs^Efm, Gs^Fms, Gs^Fms, Gs^Fds, Gs^Fds, Gs^Fms, Gs, Gs^Esa, Aa, Hh, Ww^Es, Ww^Es, Ww^Vm, Ww, Wog, Wog, Wog, Wo, Wo, Wo, Wo
Gs, Hh^Es, Gs, Gs^Esa, Gs, Gs, Gg^Efm, Gg, Gd, Hh, Wwg, Aa^Esa, Wo, Wo, Wwg, Gs^Vct, Ww, Re, Gd, Re, Gg, Gs, Gs^Fmw, Gs^Fms, Hh^Fp, Hh^Fp, Gs^Fms, Gs^Fds, Gs^Fms, Gs^Es, Gs^Efm, Aa, Gs, Ww^Es, Ds, Ww, Ww, Ww, Ww, Wog, Wog, Wo, Wo, Wo
Hhd, Hh, Gg, Gg, Gg^Efm, Gg^Efm, Gg^Efm, Gs, Gs^Edb, Hh^Fp, Ww, Ww, Hh, Hh^Fp, Hh, Ww^Ewl, Hh, Wo, Wo, Gs^Es, Gs^Esa, Hh, Hh^Fms, Gs^Fp, Hh^Fp, Hh^Fms, Hh^Fms, Gs^Fds, Gs^Fds, Gs^Fms, Gs^Fms, Gs^Efm, Co^Vct, Gs, Gd, Ds, Ce, Ww, Ww, Wog, Wog, Wo, Wo, Wo
Hh, Hhd, Gg^Es, Gs^Efm, Gg, Gg, Gs, Gs, Gs, Hh, Hh^Efm, Mm, Mm, Hh, Hhd, Hh, Gs, Gs^Es, Wwf^Es, Gs, Aa, Aa, Aa, Hh^Fds, Hh^Fp, Mm, Hh^Fms, Hh^Fms, Gs, Gs^Fms, Gs, Gs, Gs, Gs^Efm, Gs^Efm, Ce, Cv^Kov, Ce, Ds, Ww, Ww, Wog, Wo, Wo
Gs, Hh, Gg, Gg^Es, Gs, Gs^Efm, Gs, Aa, Aa, Gd, Mm, Ms, Hh^Fmw, Hhd, Ur^Kov, Ur^Kov, Ur^Kov, Gg, Wwf, Gd, Gs, Aa, Hh, Hh^Fms, Hh^Fp, Hh^Fmw, Hh^Fms, Hhd, Gs^Efm, Gd^Efm, Gs^Fp, Gs^Fp, Gs^Fds, Gs^Efm, Gs^Fms, Ce, Ce, Ce, Gg, Hh, Hhd, Ww, Wo, Wo
Gs, Gs, Gd, Gd, Gd, Gs, Hh^Fms, Aa, Hh, Hhd, Mm, Mm, Hh^Fds, Gs, Ur^Kov, Gll^Feth, Ur^Kov, Gs, Wo, Gs, Hh, Gs^Esa, Hhd, Hh^Fms, Hh^Fp, Hh^Fp, Hh^Fms, Gs^Efm, Gs^Efm, Gd^Efm, Gs^Fms, Gs^Fp, Gs^Fds, Gs^Fds, Gs^Fds, Gs, Gs^Fms, Gs, Gg^Efm, Gs, Hhd, Ww, Ww^Vm, Wo
Gs, Gd, Hh, Gs, Gs, Hh^Fms, Hh^Fmw, Hh^Fmw, Hh^Fms, Hhd, Hh^Fp, Hh, Hh^Fds, Gs^Efm, Gs^Efm, Ur^Kov, Gs, Gd, Gg, Wo, Wwg, Hh^Fp, Hh, Hhd, Gs^Fms, Gs^Fp, Gd, Hh, Hh, Gd, Gs, Gs^Fp, Gs^Fds, Gs^Fds, Gs^Fds, Gs^Fds, Gs^Fms, Gs^Efm, Gg^Efm, Hh^Efm, Hhd, Ww^Es, Ww, Ww
Gs, Gs, Ce, Hhd, Hh^Fms, Gs^Fds, Hh^Fms, Hh, Aa, Hh^Fp, Hh^Fp, Hh^Fp, Hh^Fms, Hh, Hh, Gs, Co^Vct, Gd, Gs, Gg, Gs, Wo, Co^Vct, Gd, Gs, Gs, Gs^Esa, Aa, Aa^Esa, Gs, Gs^Fms, Gs^Fmw, Gs, Gs^Fms, Gs, Gs^Fms, Gs^Efm, Gs^Efm, Gs, Hh, Hh, Ww, Ww, Wog
Gg, Ce, Cv^Kov, Ce, Gs^Fms, Hh^Fds, Gs^Fms, Gs^Esa, Aa, Aa^Edb, Hh^Fms, Hh^Fds, Gs^Fds, Gs^Fms, Gs^Edb, Hh, Gs, Gd, Gd, Gg, Gs, Ww, Wo, Wo, Wo, Gs^Edb, Gs, Aa, Gs^Esa, Gs, Wo, Gs, Ww, Gs, Gg^Es, Gg^Edb, Gg, Gs^Efm, Ds, Ds, Wwr, Ww, Wog, Wog
Gs, Ce, Ce, Ce, Gs^Fms, Gs^Fds, Gs^Fp, Gs^Fms, Gs^Esa, Aa, Gs^Fms, Hh^Fds, Gs^Fds, Gs, Aa, Aa, Gs^Esa, Gs^Efm, Gs^Efm, Gg, Gs^Efm, Gs^Efm, Gd, Gd, Gs, Ww^Es, Ww, Wwg, Wwg, Wo, Ww^Ewl, Wo, Gs, Wo, Wo, Wo, Wo, Ds, Ww, Wwr, Ww, Wog, Wo, Wo
Gs^Efm, Gs, Gs, Gs, Gs, Hh^Fms, Hh^Fp, Hh^Fds, Gs^Efm, Gs^Efm, Gs^Fms, Gs^Fds, Gs^Fds, Gs^Fms, Gs^Esa, Aa, Gs^Esa, Gs^Efm, Gs^Efm, Gg^Efm, Gs, Gs^Efm, Gs, Gs, Gg^Es, Gs, Gd, Gs, Gs^Fms, Gs, Gs^Fms, Gs, Hh, Co^Vct, Ds, Wo, Wo, Wo, Wog, Ww, Ww, Ww, Wo, Wo
Gs^Efm, Gs^Efm, Hhd, Gs, Gs^Es, Gs^Fms, Hh^Fms, Hh^Fp, Hh^Fmw, Gs^Efm, Gs^Fds, Gs^Fds, Gs^Fds, Gs, Gs, Aa, Gg, Gs, Gs, Gs, Gs, Gs, Gg, Gg^Edb, Gs^Efm, Gs^Efm, Gd^Efm, Gs, Gs^Fds, Gs^Fms, Gs^Fms, Hh, Hhd, Ds, Ww, Ww, Wo, Wog, Wo, Wog, Ww, Ww, Wo, Wo
Gg^Efm, Gs^Efm, Gs, Hhd, Hhd^Es, Gs, Hh, Hh^Fp, Hh^Fp, Hh^Fms, Hh^Fds, Hh^Fms, Hh^Fds, Hh^Fms, Gs, Gg^Es, Gg, Gg, Gs, Gs^Es, Gs, Gs, Gs, Gg, Gs, Gs, Gs^Esa, Gd, Gs, Gs^Fms, Gs, Gs^Edb, Ww^Es, Ww, Ww, Ww, Ww, Wog, Wo, Wo, Wo, Wo, Wo, Wo
Gs, Gg^Efm, Gs, Gs, Gs, Hh, Gs, Hh^Fms, Hh^Fms, Hh^Fp, Hh^Fp, Hh^Fds, Hh^Fds, Gs^Fds, Gs, Gg, Gg^Efm, Gs^Efm, Gs, Gg^Es, Gs, Gs, Gs^Efm, Gs, Aa, Gs^Esa, Gs^Esa, Gs, Gs^Fds, Gs^Fms, Gs^Fms, Ww, Ww, Ww, Ww, Ww, Ww, Wo, Wo, Wo, Wo, Wo, Wo, Wo
Sm, Gs^Em, Ss, Ss, Sm, Gs, Gd^Em, Gd, Hhd, Hh^Fms, Hh^Fms, Hh^Fp, Hh^Fp, Hh^Fms, Gs^Fms, Gs^Efm, Gs, Gs^Efm, Gs, Gg, Gg^Efm, Gs, Gs, Gs^Esa, Aa, Aa^Esa, Gs^Edb, Gs^Fms, Gs^Efm, Gs, Wwr, Wwr, Ww, Ww, Ww, Ww, Ww, Ww^Vm, Wo, Wo, Wo, Wo, Wo, Wo
Ss, Sm, Sm, Ss, Ss, Ss, Sm, Gd, Gd, Hh, Gs, Hh^Fms, Hh^Fds, Hh^Fms, Hh^Fms, Gs^Fmw, Gs, Gs, Gs, Gs, Gs^Efm, Gg, Gs, Gs^Esa, Aa, Aa, Gs, Gd, Gd^Efm, Gs^Efm, Wwr, Wwr, Ww, Ww, Wog, Wo, Wo, Ww, Wo, Wo, Wo, Wo, Wo, Wo
Sm, Sm, Sm, Ss, Ss, Ss, Sm, Ss, Ss, Gd^Es, Gd, Hh, Hh^Fms, Hh^Fms, Hh, Hh^Fms, Hh, Co^Vct, Gs, Gs, Gs, Gg, Gg^Es, Gs, Gs^Esa, Gs, Gs, Gs^Efm, Ds, Ww^Es, Ww, Ww, Ww, Wo, Wog, Wo, Wo, Wo, Wo, Wo, Wo, Wo, Wo, Wo
Ss, Rb, Sm, Ss, Ss, Sm, Rb, Rb, Rb, Ss, Gs, Hh, Hhd, Mm, Hh^Fms, Hh^Fms, Gs^Esa, Hh^Esa, Hh^Esa, Hh, Gs, Gs^Efm, Gg^Efm, Gs, Gs, Gs, Gg^Efm, Ds, Ww, Ww, Wo, Ww, Wo, Wog, Wo, Wo, Wo, Wo, Wo, Wo, Wo, Wo, Wo, Wo
Sm, Ss, Ss, Sm, Sm, Ss^Vhs, Sm, Ss, Sm, Sm, Gs^Efm, Gs^Efm, Mm, Mm, Mm, Hh, Gs^Esa, Aa^Esa, Aa^Esa, Hh^Fp, Hh, Gs, Gs, Gs, Gd, Gs^Es, Gg, Ds, Wo, Wo, Wo, Wo, Wo, Wo, Wog, Wo, Wo, Wo, Wo, Wo, Wo, Wo, Wo, Wo
Rb, Sm, Ss, Ss, Ss, Ss, Sm, Ss, Ss, Sm, Gs, Hh, Mm, Mm, Hh^Fp, Hh, Gs, Aa, Aa, Gs^Esa, Gs, Gs, Gd^Efm, Gd^Efm, Gd, Gs, Wo, Wo, Wo, Wo, Wo, Wo, Wog, Wog, Ww, Wog, Wog, Wo, Wo, Wo, Wo, Wo, Wo, Wo
Rb, Rb, Ss, Ss, Ss, Sm, Sm, Rb, Sm, Sm, Gs, Hh^Efm, Hh^Fmw, Hh, Hhd, Hhd, Gs, Gs, Gs^Esa, Aa, Gs, Gd, Gs^Efm, Gs^Efm, Gg, Wo, Gs, Gs, Gd, Ds, Ww, Ww, Ww, Ww, Ww, Ww, Ww, Wog, Wo, Wo, Wo, Wo, Wo, Wo
Ss, Ss, Ss, Ss, Ss, Sm, Sm, Sm, Sm, Gs, Gs^Efm, Hh^Fp, Hh^Fms, Hh, Gs^Es, Hh, Co^Vct, Gs, Gs, Gs^Esa, Gs, Gs^Efm, Gs, Gs, Wo, Wo, Gs^Esa, Aa, Aa, Aa, Ds, Ww, Ww^Es, Ww, Ww, Ww^Vm, Ww, Ww, Wwr, Wo, Wo, Wo, Wo, Wo
Ss, Ss^Vhs, Sm, Sm, Sm, Sm, Ss, Ss, Gs^Esa, Gs, Hh^Esa, Hh^Fp, Hh^Fds, Hh^Fms, Gs, Gs, Gs, Hh, Gs, Gs, Wo, Gg^Es, Ww, Gs, Wo, Gs, Gs, Aa^Esa, Aa, Gs^Esa, Gs^Fds, Gs^Fds, Gs^Fds, Wwr, Wwr, Ww^Es, Ww, Wwr, Wwr, Wo, Wo, Wo, Wo, Wo
Ss, Ss, Rb, Rb, Rb, Sm, Ss, Sm, Aa, Aa, Hh, Hh^Fds, Hh^Fds, Hh^Fms, Gs, Gg^Efm, Gs^Efm, Gd, Gd, Wo, Hh, Wwg, Hh, Wo, Gg^Efm, Gs^Es, Gs^Efm, Gs^Esa, Gd, Gs^Fds, Gs^Fds, Gs^Fms, Ds, Ds, Wwr, Ww, Ww, Ww, Wog, Wo, Wo, Wo, Wo, Wo
Sm, Sm, Ss, Rb, Sm, Sm, Ss, Gs^Esa, Aa, Aa^Esa, Gs, Hh^Fms, Gs^Fds, Hh^Fds, Hh^Fms, Gg^Efm, Gs, Gd^Efm, Gs^Efm, Wwg, Hh, Hhd, Gs, Gs, Gs^Efm, Gg^Efm, Gs, Gd, Gd, Gs, Gs^Efm, Gg, Ds, Wwr, Ww^Es, Ww, Ww, Ww, Wog, Wo, Wo, Wo, Wo, Wo
Sm, Sm, Ss, Sm, Ss, Sm, Sm, Gs, Gs, Gs^Esa, Gs, Gs^Fms, Gs, Hh^Fds, Hh^Fmw, Gs, Gd, Gd, Wwf, Ww, Gs, Gs^Es, Gs, Gs, Gs^Efm, Gg, Gg, Gs, Gd, Gs^Efm, Gg, Gs^Edb, Gs^Fds, Wwr, Ww, Ww, Ww, Ww, Wog, Wog, Wo, Wo, Wo, Wo
Ss, Sm, Ss, Ss, Sm, Sm, Sm, Ss, Gs^Em, Gs^Efm, Gs^Efm, Gs^Efm, Gs, Gs^Fms, Gs, Gs, Wwf, Wwf^Es, Gs, Gs, Co^Edt, Ko, Co^Edt, Gs^Edt, Gs, Gs, Hh^Es, Hh^Efm, Gd, Gg^Es, Gs^Fds, Gs^Fds, Gs^Fms, Gs^Fds, Ww, Ww, Ww, Ww, Ww, Wog, Wo, Wo, Wo, Wo
Sm, Sm, Sm, Ss, Ss, Ss, Ss, Sm, Gs, Gg, Hh, Hh^Es, Gs, Gs, Wo, Ww, Gs, Gs, Rb, Co, Rd, Rb, Rb, Co, Rd, Gs, Gs, Hh, Gd, Gs, Gs^Fds, Gs^Fds, Gs^Fds, Gs^Fds, Gs^Fds, Ww, Ww, Ww, Wwr, Ww, Wo, Wo, Wo, Wo
Sm, Sm, Ss, Sm, Sm, Ss, Sm, Sm, Gs, Gg, Hh, Gs^Es, Wo, Wo, Gs, Gs^Edt, Co, Co^Edt, Re, Rb, Rb^Vct, Rd^Vct, Re^Vct, Rb^Edt, Rb, Co, Co^Edt, Gs, Gd, Gs, Gs^Fds, Gs^Fds, Gs^Fms, Gs^Fds, Gs^Fds, Ww, Ww, Ww^Es, Wwr, Ww, Wog, Wo, Wo, Wo
Sm, Ss, Sm, Sm, Ss, Ss, Ss, Sm, Gs, Gg^Efm, Gs, Ww, Gs, Gs^Efm, Gs^Efm, Gs, Ko, Gd^Edt, Rb^Vct, Rb^Vct, Re^Vct, Rb^Vct, Rd^Vct, Re^Vct, Rb^Vct, Re^Edt, Ko, Gs, Gs, Gs, Gs^Fds, Gs^Fms, Gs^Fds, Gs^Fds, Gs^Fds, Gd, Ww, Ww, Ww, Ww, Wog, Wo, Wo, Wo
Ss, Ss, Ss, Rb, Ss, Ss, Ss, Gs, Gs^Efm, Gs^Efm, Gs, Wwf, Gs, Gs^Efm, Gd^Es, Gs, Co^Edt, Rb, Rb^Vct, Re^Vct, Rb^Vct, Rb^Vct, Rb^Vct, Re^Vct, Rb^Vct, Rb, Co^Edt, Gs^Efm, Gs^Efm, Gs^Fds, Gs^Fms, Gs^Fms, Gs^Fds, Gs^Fds, Gs^Fds, Ds, Ds, Ww, Ww, Ww, Wog, Wo, Wo, Wo
Sm, Sm, Ss, Ss^Vhs, Ss, Sm, Gs, Gs, Gd^Efm, Gd, Gs, Wwf, Gs^Es, Gd, Gd^Efm, Gs, Gs, Co, Rd, Rd^Vct, Re^Vct, Gd^Vct, Rb^Vct, Rd^Vct, Rb, Co, Gs, Gs, Gg^Efm, Gg, Gg, Gg, Gg, Gs^Fds, Gs, Gd^Efm, Ds, Ww, Ww, Ww, Wog, Wog, Wog, Wo
Sm, Rb, Ss, Ss, Gs^Em, Gs, Gs, Gd, Gd, Gd, Ww, Wwf, Gs, Gs, Gd^Efm, Gd, Gs, Rb, Co, Gd^Edt, Rb^Edt, Rb, Rb, Rb, Co, Rb, Gs, Gs, Gg^Efm, Gg, Gs, Gs, Gs, Gg, Gg^Efm, Gs^Efm, Gs, Ds, Ww, Ww, Ww, Wog, Wog, Wo
Ss, Rb, Ss, Ss, Hh^Efm, Hh, Gd, Gd, Wwg, Ww, Gg, Gs, Hh, Gs^Efm, Gd, Gd, Gd, Gs^Edt, Co, Rb, Co, Ko, Co, Rd^Edt, Co^Edt, Gs, Gs, Gs, Gs, Gs, Gg^Efm, Gs^Efm, Gs^Efm, Gs^Efm, Gs, Gg^Efm, Gs^Efm, Gd^Efm, Ds, Ww, Ww, Ww^Vm, Wwr, Ww
Rb, Rb, Ss, Ss, Hh, Gd, Gs, Gs, Wwg, Gs, Gs, Hh^Efm, Hh, Gs^Efm, Gs^Efm, Gd^Efm, Gd, Gs, Gs, Co, Gs, Gs^Edt, Gs, Co^Edt, Gs^Edt, Gs^Edt, Hh, Hh, Hh, Gs^Es, Gg, Gg, Gs, Gs, Gs, Gg, Gs^Fds, Gs^Fds, Gs^Fms, Ds, Ww, Ww^Es, Wwr, Wwr
Ss, Ss, Ss, Ss, Gs, Gs, Gs, Gd, Wwg, Gs, Gs, Hh, Gs, Gs, Gs, Gs, Gs, Gd, Gs, Gs, Gs, Gs, Gs, Gs, Gs, Gs, Gs, Hh^Efm, Gs, Gg, Gs, Gs, Gs, Gs^Fds, Gs^Fds, Gs^Fds, Gs^Fds, Gs^Fms, Gd, Gs^Fms, Gs, Ww, Ww, Ww
