Mm, Ql, Hh, Mm, Hh, Mm, Ql, Ql, Mm
Hh, Ql, Uh, Mm, Md, Mm, Ql, Uh, Mm
Ql, Ql, Ql, Md, Qlf, Ql, Ql, Mm, Hh
Hh, Uh, Md, Qlf, Qlf, Qlf, Qlf, Md, Hh
Mm, Md, Qlf, Qlf, Qlf, Qlf, Qlf, Md, Hh
Md, Md, Md, Qlf, Qlf, Qlf, Ql, Md, Uh
Hh, Md, Mm, Md, Ql, Md, Mm, Ql, Ql
Hh, Mm, Ql, Ql, Mm, Mm, Hh, Mm, Qlf
Hh, Uh, Ql, Mm, Mm, Hh, Hh, Uh, Uh
