Xu, Xu, Xu, Xu, Xu, Xu, Xu, Xu, Xu, Xu, Xu, Xu, Xu, Xu, Xue, Xu, Xue, Xu, Wwg, Wwg, Wwg, Xu, Xue, Xu, Xu, Xu, Xu, Xu, Xu, Xu, Xu, Xu, Xu, Xu
Xu, Xu, Xu, Xu, Xu, Xu, Xu, Xu, Uu^Edb, Xu, Tb, Xue, Xue, Xue, Xue, Xue, Xue, Xue, Wwg, Wog, Xue, Xue, Xue, Xue, Xu, Xu, Xu, Xu, Xu, Xu, Xu, Xu, Xu, Xu
Xu, Xu, Xu, Xu, Xu, Uu^Tf, Uue^Tf, Uue^Dr, Uue^Em, Uh, Ur, Uu^Em, Ur, Uh, Uh, Uu, Tb, Xu, Wog, Wwg^Es, Ur, Uu^Vu, Uue, Uh, Uue, Uu, Uu, Uh, Uh, Xu, Xu, Xu, Xu, Xu
Xu, Xu, Xu, Xu, Tb, Uu^Tf, Uue^Tf, Uue^Tf, Uue^Em, Uh, Uh, Ur, Xu, Uh, Uu^Edb, Ur^Em, Wwg, Wwf^Es, Wwf, Wwg, Uh, Ur, Uu, Uue^Edb, Ur, Ur, Ur^Edb, Uh, Uh, Xu, Xu, Xu, Xu, Xu
Xu, Xu, Xue, Xu, Uh^Es, Uh^Em, Uue^Em, Uue^Em, Uu^Em, Uue, Uu^Vu, Ur, Xu, Uu^Tf, Wog, Wwf, Wog, Wog, Uue^Edt, Uue^Dr, Uh, Uh, Xu, Xu, Xu, Xu, Uu, Ur, Uue, Uu^Vu, Xu, Xu, Xu, Xu
Xue, Xue, Xue, Xue, Uh, Uue, Uu, Ur, Xu, Ur, Tb, Uu, Xu, Uu^Tf, Wwg, Wwg^Edb, Ss, Ss, Ss, Uue^Es, Ur^Em, Ur^Em, Tb, Uu^Tf, Uu^Tf, Xu, Xu, Xu, Ur^Em, Uue^Em, Cte, Kte, Xu, Xu
Xue, Xue, Uu^Tf, Uu^Tf, Uu, Uh, Ur, Ur, Uu^Vu, Xu, Xu, Xu, Xu, Ss, Ss^Edb, Ss, Ss, Ss^Es, Ss^Edb, Sm, Sm^Edb, Uue, Uue, Uu^Tf, Xu, Xu, Tb, Uh, Uue, Uue, Uu^Tf, Cte, Xu, Xu
Xue, Xue, Uu, Uu^Tf, Uu, Uue^Edb, Uue, Ur, Uh, Tb, Xue, Xue, Xue, Ss, Ss, Sm^Edb, Uue^Tf, Ss^Edb, Cer, Cer^Edb, Cer, Sm, Uue^Tf, Sm^Edt, Xu, Xu, Uu^Vu, Uue, Ur, Uu^Tf, Uu^Tf, Xue, Xu, Xu
Xu, Xue, Xue, Tb, Cte^Em, Tb, Uu^Em, Uh, Uue, Xu, Ur, Tb, Xue, Xu, Xu, Uue^Tf, Uue^Tf, Ss^Edb, Cer^Edb, Ker, Cer^Edb, Sm, Sm^Edb, Sm, Xu, Xu, Uh, Ur^Dr, Ur, Uu^Edb, Xue, Xue, Xu, Xu
Xu, Xu, Xu, Cte, Kte, Cte^Em, Xu, Ur^Dr, Uh, Ur^Edb, Uh, Uu, Ur, Xu, Xu, Xu, Xue, Xu, Xu, Cer, Tb, Sm^Edb, Uue^Tf, Sm^Tf, Xu, Uh, Uh, Uue, Uue, Ur, Xue, Xu, Xu, Xu
Xu, Xu, Xu, Xu, Xu, Xu, Xu, Xue, Xue, Uh^Edb, Uh, Ur, Uu^Tf, Ur^Edb, Ur, Xu, Uu^Vu, Xue, Xue, Xue, Xu, Uue, Xu, Xu, Xu, Xu, Xu, Uu^Tf, Uue, Ur, Xue, Xu, Xu, Xu
Xu, Xu, Xu, Xu, Xu, Xu, Xu, Xu, Xu, Xue, Xue, Uu^Tf, Uu^Tf, Uu^Edb, Uue, Uue, Uue, Uue^Fms, Uh^Edb, Uu^Em, Uu^Dr, Xu, Uu^Tf, Uu^Tf, Qxu, Qxu, Qxu, Ur^Em, Ur^Edb, Uu^Tf, Xu, Xu, Xu, Xu
Xu, Xu, Xu, Xu, Xu, Xu, Xu, Xu, Xu, Xu, Xu, Xu, Xu, Xu, Xu, Ur^Edb, Uue^Edb, Uh, Uue^Edb, Uu^Em, Ur, Xu, Ur^Es, Ur^Em, Ur^Es, Qxu, Qxu^Bs/, Ur, Tb, Uu^Tf, Xu, Xu, Xu, Xu
Xu, Xu, Xu, Xu, Xu, Xu, Xu, Xu, Xu, Xu, Xu, Xu, Xu, Xu, Xu, Xu, Uu^Es, Ur, Tb, Uue, Ur, Tb, Uh, Uh, Ur^Edb, Qxu^Bs/, Qxu, Qxu, Qxu, Tb, Xu, Xu, Xu, Xu
Xu, Xu, Xu, Xu, Xu, Xu, Xu, Xu, Xu, Xu, Xu, Xu, Xu, Xu, Xu, Xu, Tb^Es, Ur^Dr, Uh^Es, Xu, Xu, Uh, Xu, Uu^Vu, Ur^Em, Qxu, Qxu, Qxu, Xu, Xu, Xu, Xu, Xu, Xu
Xu, Xu, Xu, Xu, Xu, Xu, Xu, Xu, Xu, Xu, Xu, Xu, Xu, Xu, Xot, Xot, Urb^Es, Urb^Dr, Urb^Es, Xot, Xot, Xu, Xu, Xu, Xu, Xu, Xu, Xu, Xu, Xu, Xu, Xu, Xu, Xu
Xu, Xu, Xu, Xu, Xu, Xu, Xu, Xu, Xu, Xu, Xu, Xu, Xuc, Xuc, Urb, Urb^Es, Ce, Urb, Ce, Urb^Es, Urb^Tf, Xuc, Xot, Xu, Xu, Xu, Xu, Xu, Xu, Xu, Xu, Xu, Xu, Xu
Xu, Xu, Xu, Xu, Xu, Xu, Xu, Xu, Xu, Xu, Xot, Xoa, Urb^Tf, Urb^Em, Urb, Urb, Ce, Ke, Ce, Urb^Em, Urb^Tf, Urb^Tf, Urb, Xoa, Xot, Xu, Xu, Xu, Xu, Xu, Xu, Xu, Xu, Xu
Xu, Xu, Xu, Xu, Xu, Xu, Xu, Xu, Xoa, Xot, Urb^Es, Urb, Urb^Em, Urb^Em, Urb, Urb, Urb, Urb, Urb, Urb^Em, Urb^Em, Urb^Em, Urb^Es, Urb, Xot, Xu, Xu, Xu, Xu, Xu, Xu, Xu, Xu, Xu
Xu, Xu, Xu, Xu, Xu, Xu, Xu, Xu, Xu, Urb, Urb, Urb, Urb, Urb, Urb, Urb, Urb, Urb, Urb, Urb, Urb, Urb, Urb, Urb, Xu, Xu, Xu, Xu, Xu, Xu, Xu, Xu, Xu, Xu
