Gs^Fds, Gs^Fds, Gs^Fds, Gs^Fds, Gs^Fms, Hh^Fp, Gs^Fms, Gs^Fds, Gs^Fds, Gs^Fds, Gg^Efm, Gg, Gg, Gg, Gg, Gg, Re, Gg^Efm, Gg, Gg, Gg, Gg, Gg^Efm, Gg^Efm, Gg^Efm, Gg, Gg, Gg, Re, Gg, Gg, Gg
Gll, Gll^Em, Gs^Fms, Gs^Fms, Hh^Fp, Hh^Fp, Gs^Fms, Gs^Fds, Gs^Fds, Gs^Fds, Gll, Gg, Gll, Gg, Re, Re, Gg^Efm, Re, Gll, Gg, Re, Gg, Re, Gg, Gg^Edb, Gg, Re, Re, Gg^Efm, Gg, Gll, Gg
Gs^Fds, Gs^Fms, Gs^Fms, Hh^Fp, Hh^Fp, Hh^Fp, Gs^Fms, Gs^Fds, Gs^Fds, Gll, Gd^Fetd, Gg, Re, Gg^Es, Gg, Gg^Efm, Gs^Fds, Gll, Gll, Gg, Gg, Re, Gg^Efm, Re, Gll, Gg, Gg^Es, Gg^Efm, Gll, Gg, Gs^Fds, Gg
Gs^Fds, Gs^Fms, Hh^Fp, Hh^Fp, Gs^Fms, Gs^Fms, Gs^Fds, Gs^Fds, Gg, Gll, Re, Re, Gll, Gg, Gs^Fds, Gs^Fds, Gs^Fds, Gs^Fds, Gs^Fds, Gs^Fds, Gs^Fds, Gs^Fds, Gs^Fds, Gll, Gll, Gll, Gll, Gg, Gs^Fds, Gs^Fds, Gs^Em, Gs^Fds
Gs^Fms, Gs^Fms, Hh^Fp, Hh^Fp, Gll^Em, Gll^Em, Gs^Fds, Gg^Efm, Re, Gg^Es, Gs, Gg, Gs^Fds, Gs^Fds, Gs^Fds, Gs^Fds, Gs^Fms, Gs^Fms, Gs^Fms, Gs^Fds, Gll, Gs^Fds, Gs^Fds, Gs^Fds, Gs^Fds, Gs^Fds, Gs^Fds, Gs^Fds, Gs^Fds, Gs^Fds, Gs^Fds, Gs^Fds
Hh^Fp, Gs^Fms, Hh^Fp, Gs^Fms, Gs^Fms, Gs^Fds, Gll, Re, Gll, Gll, Gs^Fds, Gs^Fds, Gs^Fds, Gs^Fds, Gll^Fp, Gs^Fms, Hh^Fp, Gs^Fms, Gs^Fms, Gll^Fp, Gs^Fms, Gll, Gll^Fp, Gs^Fds, Gs^Fds, Gs^Fds, Gll, Gll^Em, Gll^Em, Gs^Fds, Gs^Fds, Gs^Fds
Hh^Fp, Hh^Fp, Hh^Fp, Gs^Fms, Gs^Fms, Gs^Fds, Gll, Re, Gs, Gs^Fds, Gs^Fds, Gs^Fds, Gll^Es, Gs^Fms, Mm, Mm^Esa, Mm, Gs^Fms, Hh^Fp, Gs^Fms, Gs^Fms, Gs^Fms, Hh^Fp, Gs^Fms, Gll^Fp, Gs^Fms, Gs^Fms, Gs^Fms, Gs^Fms, Gs^Fds, Gs^Fds, Gs^Fds
Gs^Fms, Hh^Fp, Hh^Fp, Hh^Fp, Hh^Fp, Gs^Fms, Gg^Es, Gg, Gg^Edb, Gs^Fds, Gs^Fds, Gs^Fds, Gll^Fp, Gll^Es, Gs^Fms, Mm, Gs^Fms, Hh^Fp, Hh^Fp, Gs^Fms, Hh^Fp, Hh^Fp, Hh^Fp, Gs^Fms, Gs^Fms, Gs^Fms, Hh^Fp, Hh^Fp, Hh^Fp, Gll^Fp, Gs^Fds, Gs^Fds
Gs^Fms, Gll^Fp, Hh^Fp, Hh^Fp, Gll^Fp, Gs^Fms, Gll, Re, Gg, Gs^Fds, Gs^Fds, Gs^Fds, Gs^Fds, Gs^Fds, Gll^Fp, Gs^Fms, Hh^Fp, Gs^Fms, Hh^Fp, Hh^Fp, Gs^Fms, Gs^Fms, Hh^Fp, Gs^Fms, Hh^Fp, Hh^Fp, Gs^Fms, Gs^Fms, Gs^Fms, Gll^Fp, Gs^Fds, Gs^Fds
Gs^Fms, Gs^Fms, Hh^Fp, Gs^Fms, Gs^Fms, Gs^Fds, Gg^Efm, Re, Re, Gs^Fds, Gs^Fds, Gs^Fds, Gll^Em, Gs^Fds, Gs^Fds, Gs^Fms, Gs^Fms, Hh^Fp, Hh^Fp, Gs^Fms, Gs^Fms, Gs^Fms, Gs^Fms, Hh^Fp, Hh^Fp, Gs^Fms, Gs^Fms, Gs^Fms, Gs^Fms, Gs^Fms, Gs^Fds, Gs^Fds
Gs^Fms, Hh^Fp, Hh^Fp, Hh^Fp, Gs^Fms, Gs^Fds, Gll, Gg, Gs^Fds, Re, Re, Gs^Fds, Gs^Fds, Gs^Fds, Gs^Fds, Gs^Fms, Gs^Fms, Hh^Fp, Hh^Fp, Gs^Fms, Gs^Fms, Gs^Fms, Gs^Fms, Hh^Fp, Gs^Fms, Hh^Fp, Hh^Fp, Hh^Fp, Gs^Fms, Gs^Fms, Gs^Fds, Gs^Fds
Gs^Fms, Hh^Fp, Hh^Fp, Gs^Fms, Gll, Gll, Gs^Fms, Gs^Fms, Gs^Fms, Gs^Fds, Gll, Gg^Es, Gs^Fds, Gs^Fds, Gs^Fds, Gs^Fds, Gs^Fms, Gs^Fms, Hh^Fp, Gs^Fms, Gs^Fms, Gs^Fms, Gs^Fms, Hh^Fp, Hh^Fp, Gs^Fms, Gs^Fms, Gs^Fms, Gs^Fds, Gs^Fds, Gs^Fds, Gs^Fds
Gs^Fms, Gs^Fms, Hh^Fp, Hh^Fp, Gll, Gs^Fms, Hh^Fp, Gs^Fms, Gs^Fms, Gs^Fds, Gs^Fds, Re, Gg, Gs^Fds, Gs^Fds, Gs^Fds, Gs^Fms, Gs^Fms, Hh^Fp, Gs^Fms, Gs^Fms, Gs^Fds, Gs^Fds, Gll^Fp, Gll^Fp, Gll^Fp, Gs^Fds, Gs^Fds, Gs^Fds, Gs^Fds, Gs^Fds, Gs^Fds
Gs^Fds, Gll^Fp, Gll^Fp, Hh^Fp, Hh^Fp, Hh^Fp, Hh^Fp, Gs^Fms, Gs^Fms, Gs^Fds, Gs^Fds, Re, Gg^Efm, Gll, Gs^Fds, Gs^Fds, Gs^Fds, Gs^Fms, Gs^Fms, Gs^Fms, Gs^Em, Gs^Es, Gs^Fds, Gs^Fds, Gs^Fds, Gs^Fms, Gs^Fds, Gs^Fds, Gs^Fds, Gs^Fds, Gs^Fds, Gs^Fds
Gs^Fds, Gs^Fds, Gll, Gs^Fms, Gs^Fms, Hh^Fp, Gll^Fp, Hh^Fp, Gs^Fms, Gs^Fds, Gs^Fds, Re, Gll, Gll, Gs^Fds, Gs^Fds, Gs^Fds, Gs^Fms, Gs^Fds, Gs^Fms, Gs^Fds, Gs^Fds, Gs^Fds, Gs^Fds, Gs^Fds, Gs^Fds, Gs^Fds, Gs^Fds, Gs^Fds, Gs^Fds, Gs^Fds, Gs^Fds
Gs^Fds, Gs^Fds, Gs^Fds, Gs^Fms, Gs^Fms, Gs^Fms, Gs^Fms, Gs^Fms, Gs^Fms, Gs^Fds, Gs^Fds, Re, Gll, Gs^Fds, Gs^Fds, Gs^Fds, Gs^Fds, Gs^Fds, Gs^Fds, Gs^Fds, Gs^Fds, Gs^Fds, Gs^Fds, Gs^Fds, Gs, Gg, Gg, Gs^Fds, Gs^Fds, Gs^Fds, Gs^Fds, Gs^Fds
Gs^Fds, Gs^Fds, Gs^Fds, Gs^Fds, Gs^Fds, Gs^Fds, Gs^Fds, Gs^Fds, Gs^Fds, Gs^Fds, Gg, Re, Re, Gs^Fds, Gs^Fds, Gs^Fds, Gs^Fds, Gs^Fds, Gs^Fds, Gs^Fds, Gg, Gg, Gg, Gg, Gg, Gs, Gg, Gg^Em, Gg^Em, Gg^Em, Gg, Gg
Gg, Gg^Em, Gg, Gg, Gg, Gg^Em, Gg, Gg, Gg^Edt, Gg, Cer, Gg^Edt, Re^Vct, Gg, Gg, Gs^Fds, Gg^Em, Gg^Em, Gg, Gg, Gg, Gs, Gg^Fds, Gg, Gg^Fds, Gg^Efm, Gg^Efm, Gs^Efm, Gg, Gg, Gg, Gg
